,町丁目,世帯数,総数,男,女,年度,月次,公開件数
0,後楽一丁目,435,721,358,363,2016,1,1
1,後楽二丁目,861,1505,745,760,2016,1,30
2,春日一丁目,953,1505,673,832,2016,1,44
3,春日二丁目,2039,4038,1934,2104,2016,1,74
4,小石川一丁目,1849,3512,1618,1894,2016,1,43
5,小石川二丁目,2134,3918,1868,2050,2016,1,67
6,小石川三丁目,2497,5152,2456,2696,2016,1,74
7,小石川四丁目,1747,3529,1609,1920,2016,1,65
8,小石川五丁目,2883,5522,2523,2999,2016,1,130
9,白山一丁目,2621,4667,2296,2371,2016,1,138
10,白山二丁目,2234,4141,2031,2110,2016,1,131
11,白山三丁目,532,1020,500,520,2016,1,25
12,白山四丁目,2257,4334,2062,2272,2016,1,53
13,白山五丁目,2116,3742,1715,2027,2016,1,100
14,千石一丁目,1883,3833,1796,2037,2016,1,120
15,千石二丁目,2022,4190,2029,2161,2016,1,38
16,千石三丁目,2129,4300,2070,2230,2016,1,60
17,千石四丁目,3214,5544,2652,2892,2016,1,216
18,水道一丁目,1408,2604,1283,1321,2016,1,46
19,水道二丁目,1945,3098,1565,1533,2016,1,167
20,小日向一丁目,1143,2242,1029,1213,2016,1,17
21,小日向二丁目,1075,2409,1160,1249,2016,1,36
22,小日向三丁目,647,1289,612,677,2016,1,19
23,小日向四丁目,937,1755,830,925,2016,1,55
24,大塚一丁目,533,1137,511,626,2016,1,10
25,大塚二丁目,1062,1934,826,1108,2016,1,12
26,大塚三丁目,2108,3500,1624,1876,2016,1,161
27,大塚四丁目,1784,3058,1418,1640,2016,1,68
28,大塚五丁目,2390,4342,2059,2283,2016,1,77
29,大塚六丁目,2203,3820,1930,1890,2016,1,64
30,関口一丁目,2623,4460,2088,2372,2016,1,167
31,関口二丁目,489,1014,479,535,2016,1,9
32,関口三丁目,449,926,452,474,2016,1,13
33,目白台一丁目,1240,2197,1173,1024,2016,1,30
34,目白台二丁目,1160,2126,1003,1123,2016,1,23
35,目白台三丁目,1323,2541,1171,1370,2016,1,44
36,音羽一丁目,2356,4013,1794,2219,2016,1,120
37,音羽二丁目,960,1717,755,962,2016,1,46
38,本郷一丁目,2139,4208,1938,2270,2016,1,89
39,本郷二丁目,1848,3101,1466,1635,2016,1,98
40,本郷三丁目,1927,3016,1382,1634,2016,1,73
41,本郷四丁目,2249,4110,1962,2148,2016,1,81
42,本郷五丁目,1878,3331,1699,1632,2016,1,49
43,本郷六丁目,1105,1919,966,953,2016,1,54
44,湯島一丁目,456,678,314,364,2016,1,22
45,湯島二丁目,1629,2685,1365,1320,2016,1,98
46,湯島三丁目,1840,2825,1403,1422,2016,1,141
47,湯島四丁目,1182,2109,1063,1046,2016,1,46
48,西片一丁目,1178,2380,1136,1244,2016,1,40
49,西片二丁目,1449,2865,1425,1440,2016,1,46
50,向丘一丁目,1809,3329,1658,1671,2016,1,71
51,向丘二丁目,1846,3218,1511,1707,2016,1,71
52,弥生一丁目,232,415,203,212,2016,1,2
53,弥生二丁目,810,1533,735,798,2016,1,43
54,根津一丁目,1378,2491,1108,1383,2016,1,26
55,根津二丁目,2234,3813,1812,2001,2016,1,50
56,千駄木一丁目,710,1481,682,799,2016,1,18
57,千駄木二丁目,2528,4368,2065,2303,2016,1,107
58,千駄木三丁目,3789,6736,3197,3539,2016,1,154
59,千駄木四丁目,1627,3018,1479,1539,2016,1,66
60,千駄木五丁目,2226,4591,2212,2379,2016,1,83
61,本駒込一丁目,2353,4594,2165,2429,2016,1,90
62,本駒込二丁目,2611,4996,2432,2564,2016,1,107
63,本駒込三丁目,1807,3266,1550,1716,2016,1,65
64,本駒込四丁目,2122,4168,2004,2164,2016,1,101
65,本駒込五丁目,3064,5707,2730,2977,2016,1,176
66,本駒込六丁目,1816,3576,1652,1924,2016,1,60
67,後楽一丁目,441,728,362,366,2016,2,3
68,後楽二丁目,860,1509,751,758,2016,2,19
69,春日一丁目,958,1511,672,839,2016,2,48
70,春日二丁目,2040,4033,1933,2100,2016,2,89
71,小石川一丁目,1831,3491,1610,1881,2016,2,51
72,小石川二丁目,2137,3928,1879,2049,2016,2,58
73,小石川三丁目,2498,5139,2447,2692,2016,2,44
74,小石川四丁目,1752,3552,1622,1930,2016,2,61
75,小石川五丁目,2897,5541,2527,3014,2016,2,113
76,白山一丁目,2633,4686,2306,2380,2016,2,134
77,白山二丁目,2235,4141,2034,2107,2016,2,119
78,白山三丁目,526,1008,489,519,2016,2,23
79,白山四丁目,2253,4333,2064,2269,2016,2,60
80,白山五丁目,2121,3736,1714,2022,2016,2,98
81,千石一丁目,1878,3824,1788,2036,2016,2,87
82,千石二丁目,2035,4203,2034,2169,2016,2,51
83,千石三丁目,2130,4316,2078,2238,2016,2,48
84,千石四丁目,3205,5536,2653,2883,2016,2,224
85,水道一丁目,1404,2600,1283,1317,2016,2,47
86,水道二丁目,1956,3110,1578,1532,2016,2,169
87,小日向一丁目,1144,2251,1031,1220,2016,2,21
88,小日向二丁目,1072,2406,1155,1251,2016,2,48
89,小日向三丁目,650,1293,615,678,2016,2,21
90,小日向四丁目,939,1759,836,923,2016,2,45
91,大塚一丁目,532,1137,510,627,2016,2,10
92,大塚二丁目,1070,1944,829,1115,2016,2,10
93,大塚三丁目,2122,3520,1625,1895,2016,2,140
94,大塚四丁目,1790,3063,1430,1633,2016,2,59
95,大塚五丁目,2391,4355,2066,2289,2016,2,76
96,大塚六丁目,2199,3818,1922,1896,2016,2,62
97,関口一丁目,2611,4445,2082,2363,2016,2,175
98,関口二丁目,491,1020,480,540,2016,2,15
99,関口三丁目,449,927,453,474,2016,2,13
100,目白台一丁目,1231,2192,1170,1022,2016,2,39
101,目白台二丁目,1165,2136,1006,1130,2016,2,33
102,目白台三丁目,1327,2536,1170,1366,2016,2,40
103,音羽一丁目,2359,4029,1804,2225,2016,2,104
104,音羽二丁目,966,1721,756,965,2016,2,29
105,本郷一丁目,2148,4211,1944,2267,2016,2,75
106,本郷二丁目,1857,3122,1475,1647,2016,2,108
107,本郷三丁目,1919,3008,1376,1632,2016,2,91
108,本郷四丁目,2243,4115,1959,2156,2016,2,76
109,本郷五丁目,1888,3348,1704,1644,2016,2,63
110,本郷六丁目,1110,1926,968,958,2016,2,52
111,湯島一丁目,456,676,314,362,2016,2,31
112,湯島二丁目,1632,2696,1377,1319,2016,2,123
113,湯島三丁目,1851,2840,1412,1428,2016,2,121
114,湯島四丁目,1181,2114,1067,1047,2016,2,39
115,西片一丁目,1184,2388,1138,1250,2016,2,35
116,西片二丁目,1444,2861,1426,1435,2016,2,53
117,向丘一丁目,1824,3372,1683,1689,2016,2,64
118,向丘二丁目,1842,3209,1511,1698,2016,2,91
119,弥生一丁目,233,416,206,210,2016,2,7
120,弥生二丁目,809,1524,734,790,2016,2,32
121,根津一丁目,1374,2492,1110,1382,2016,2,25
122,根津二丁目,2237,3815,1810,2005,2016,2,45
123,千駄木一丁目,711,1485,683,802,2016,2,18
124,千駄木二丁目,2533,4389,2074,2315,2016,2,108
125,千駄木三丁目,3775,6718,3188,3530,2016,2,144
126,千駄木四丁目,1632,3017,1478,1539,2016,2,70
127,千駄木五丁目,2218,4586,2216,2370,2016,2,67
128,本駒込一丁目,2351,4602,2172,2430,2016,2,91
129,本駒込二丁目,2617,5018,2440,2578,2016,2,75
130,本駒込三丁目,1812,3271,1553,1718,2016,2,53
131,本駒込四丁目,2126,4168,2001,2167,2016,2,88
132,本駒込五丁目,3080,5717,2746,2971,2016,2,152
133,本駒込六丁目,1818,3588,1660,1928,2016,2,57
134,後楽一丁目,431,719,356,363,2016,3,7
135,後楽二丁目,858,1502,748,754,2016,3,26
136,春日一丁目,959,1520,680,840,2016,3,32
137,春日二丁目,2042,4036,1932,2104,2016,3,70
138,小石川一丁目,1821,3464,1600,1864,2016,3,58
139,小石川二丁目,2137,3931,1882,2049,2016,3,61
140,小石川三丁目,2489,5140,2448,2692,2016,3,68
141,小石川四丁目,1772,3585,1641,1944,2016,3,77
142,小石川五丁目,2909,5550,2527,3023,2016,3,126
143,白山一丁目,2630,4688,2301,2387,2016,3,139
144,白山二丁目,2233,4138,2028,2110,2016,3,89
145,白山三丁目,518,1005,486,519,2016,3,34
146,白山四丁目,2254,4333,2066,2267,2016,3,58
147,白山五丁目,2125,3737,1714,2023,2016,3,94
148,千石一丁目,1875,3815,1783,2032,2016,3,89
149,千石二丁目,2037,4190,2029,2161,2016,3,55
150,千石三丁目,2125,4306,2074,2232,2016,3,47
151,千石四丁目,3199,5543,2665,2878,2016,3,214
152,水道一丁目,1409,2604,1290,1314,2016,3,57
153,水道二丁目,1956,3115,1579,1536,2016,3,137
154,小日向一丁目,1133,2236,1022,1214,2016,3,20
155,小日向二丁目,1074,2413,1159,1254,2016,3,38
156,小日向三丁目,655,1297,619,678,2016,3,28
157,小日向四丁目,945,1772,842,930,2016,3,34
158,大塚一丁目,530,1136,509,627,2016,3,8
159,大塚二丁目,1061,1934,829,1105,2016,3,25
160,大塚三丁目,2136,3541,1636,1905,2016,3,161
161,大塚四丁目,1807,3084,1440,1644,2016,3,59
162,大塚五丁目,2385,4349,2068,2281,2016,3,70
163,大塚六丁目,2234,3897,1960,1937,2016,3,68
164,関口一丁目,2616,4475,2097,2378,2016,3,170
165,関口二丁目,490,1013,478,535,2016,3,17
166,関口三丁目,453,935,456,479,2016,3,17
167,目白台一丁目,1219,2188,1158,1030,2016,3,45
168,目白台二丁目,1169,2149,1014,1135,2016,3,24
169,目白台三丁目,1328,2539,1175,1364,2016,3,51
170,音羽一丁目,2354,4017,1798,2219,2016,3,85
171,音羽二丁目,973,1730,759,971,2016,3,32
172,本郷一丁目,2150,4213,1942,2271,2016,3,103
173,本郷二丁目,1855,3115,1473,1642,2016,3,179
174,本郷三丁目,1924,3014,1378,1636,2016,3,107
175,本郷四丁目,2242,4119,1965,2154,2016,3,77
176,本郷五丁目,1886,3353,1704,1649,2016,3,66
177,本郷六丁目,1104,1923,967,956,2016,3,62
178,湯島一丁目,455,672,314,358,2016,3,40
179,湯島二丁目,1624,2689,1378,1311,2016,3,117
180,湯島三丁目,1865,2863,1424,1439,2016,3,165
181,湯島四丁目,1183,2111,1066,1045,2016,3,36
182,西片一丁目,1184,2388,1136,1252,2016,3,35
183,西片二丁目,1442,2860,1420,1440,2016,3,58
184,向丘一丁目,1818,3372,1680,1692,2016,3,89
185,向丘二丁目,1824,3181,1505,1676,2016,3,109
186,弥生一丁目,237,421,210,211,2016,3,19
187,弥生二丁目,799,1515,725,790,2016,3,41
188,根津一丁目,1382,2497,1110,1387,2016,3,33
189,根津二丁目,2237,3812,1806,2006,2016,3,47
190,千駄木一丁目,712,1487,682,805,2016,3,20
191,千駄木二丁目,2523,4378,2074,2304,2016,3,96
192,千駄木三丁目,3758,6691,3187,3504,2016,3,165
193,千駄木四丁目,1638,3026,1477,1549,2016,3,68
194,千駄木五丁目,2227,4597,2223,2374,2016,3,70
195,本駒込一丁目,2350,4596,2166,2430,2016,3,112
196,本駒込二丁目,2626,5037,2448,2589,2016,3,86
197,本駒込三丁目,1801,3264,1548,1716,2016,3,75
198,本駒込四丁目,2115,4151,1990,2161,2016,3,76
199,本駒込五丁目,3070,5703,2741,2962,2016,3,164
200,本駒込六丁目,1817,3590,1664,1926,2016,3,69
201,後楽一丁目,441,730,357,373,2016,4,5
202,後楽二丁目,860,1492,741,751,2016,4,25
203,春日一丁目,960,1524,678,846,2016,4,35
204,春日二丁目,2082,4069,1952,2117,2016,4,77
205,小石川一丁目,1819,3457,1600,1857,2016,4,63
206,小石川二丁目,2125,3923,1866,2057,2016,4,77
207,小石川三丁目,2504,5169,2464,2705,2016,4,59
208,小石川四丁目,1778,3593,1641,1952,2016,4,76
209,小石川五丁目,2921,5552,2522,3030,2016,4,114
210,白山一丁目,2628,4687,2303,2384,2016,4,96
211,白山二丁目,2243,4148,2034,2114,2016,4,82
212,白山三丁目,525,1016,488,528,2016,4,24
213,白山四丁目,2264,4333,2054,2279,2016,4,48
214,白山五丁目,2139,3747,1706,2041,2016,4,80
215,千石一丁目,1889,3853,1806,2047,2016,4,79
216,千石二丁目,2045,4231,2041,2190,2016,4,59
217,千石三丁目,2148,4336,2077,2259,2016,4,45
218,千石四丁目,3225,5577,2684,2893,2016,4,193
219,水道一丁目,1404,2598,1283,1315,2016,4,38
220,水道二丁目,1968,3132,1588,1544,2016,4,115
221,小日向一丁目,1126,2223,1019,1204,2016,4,33
222,小日向二丁目,1086,2441,1173,1268,2016,4,19
223,小日向三丁目,662,1305,628,677,2016,4,31
224,小日向四丁目,957,1787,846,941,2016,4,23
225,大塚一丁目,524,1126,504,622,2016,4,9
226,大塚二丁目,1060,1936,828,1108,2016,4,20
227,大塚三丁目,2163,3587,1653,1934,2016,4,149
228,大塚四丁目,1813,3095,1455,1640,2016,4,59
229,大塚五丁目,2390,4346,2074,2272,2016,4,81
230,大塚六丁目,2254,3918,1969,1949,2016,4,75
231,関口一丁目,2661,4559,2131,2428,2016,4,165
232,関口二丁目,492,1019,480,539,2016,4,15
233,関口三丁目,453,936,456,480,2016,4,21
234,目白台一丁目,1204,2170,1139,1031,2016,4,42
235,目白台二丁目,1172,2160,1019,1141,2016,4,39
236,目白台三丁目,1327,2533,1174,1359,2016,4,43
237,音羽一丁目,2360,4009,1792,2217,2016,4,57
238,音羽二丁目,1020,1789,805,984,2016,4,26
239,本郷一丁目,2156,4212,1942,2270,2016,4,122
240,本郷二丁目,1868,3136,1481,1655,2016,4,162
241,本郷三丁目,1928,3018,1367,1651,2016,4,74
242,本郷四丁目,2275,4170,1983,2187,2016,4,73
243,本郷五丁目,1885,3358,1697,1661,2016,4,68
244,本郷六丁目,1094,1901,956,945,2016,4,57
245,湯島一丁目,462,682,317,365,2016,4,38
246,湯島二丁目,1686,2740,1383,1357,2016,4,117
247,湯島三丁目,1868,2876,1426,1450,2016,4,173
248,湯島四丁目,1181,2110,1063,1047,2016,4,49
249,西片一丁目,1185,2392,1132,1260,2016,4,41
250,西片二丁目,1439,2867,1423,1444,2016,4,63
251,向丘一丁目,1801,3353,1659,1694,2016,4,96
252,向丘二丁目,1879,3245,1509,1736,2016,4,107
253,弥生一丁目,232,413,204,209,2016,4,13
254,弥生二丁目,804,1510,727,783,2016,4,46
255,根津一丁目,1398,2516,1122,1394,2016,4,28
256,根津二丁目,2252,3834,1821,2013,2016,4,62
257,千駄木一丁目,714,1490,684,806,2016,4,17
258,千駄木二丁目,2555,4408,2101,2307,2016,4,93
259,千駄木三丁目,3777,6674,3178,3496,2016,4,157
260,千駄木四丁目,1644,3034,1478,1556,2016,4,66
261,千駄木五丁目,2230,4601,2220,2381,2016,4,64
262,本駒込一丁目,2349,4569,2140,2429,2016,4,107
263,本駒込二丁目,2581,4986,2395,2591,2016,4,65
264,本駒込三丁目,1830,3307,1567,1740,2016,4,74
265,本駒込四丁目,2126,4164,1988,2176,2016,4,77
266,本駒込五丁目,3062,5709,2750,2959,2016,4,136
267,本駒込六丁目,1808,3581,1658,1923,2016,4,75
268,後楽一丁目,442,727,359,368,2016,5,4
269,後楽二丁目,873,1506,754,752,2016,5,29
270,春日一丁目,971,1531,676,855,2016,5,49
271,春日二丁目,2093,4090,1957,2133,2016,5,81
272,小石川一丁目,1793,3414,1578,1836,2016,5,56
273,小石川二丁目,2124,3919,1876,2043,2016,5,85
274,小石川三丁目,2512,5181,2470,2711,2016,5,43
275,小石川四丁目,1782,3599,1644,1955,2016,5,71
276,小石川五丁目,2926,5566,2531,3035,2016,5,124
277,白山一丁目,2661,4708,2319,2389,2016,5,83
278,白山二丁目,2257,4172,2042,2130,2016,5,90
279,白山三丁目,531,1024,493,531,2016,5,19
280,白山四丁目,2269,4328,2048,2280,2016,5,57
281,白山五丁目,2143,3750,1712,2038,2016,5,84
282,千石一丁目,1892,3856,1806,2050,2016,5,63
283,千石二丁目,2049,4236,2040,2196,2016,5,47
284,千石三丁目,2162,4367,2091,2276,2016,5,57
285,千石四丁目,3263,5609,2703,2906,2016,5,162
286,水道一丁目,1414,2610,1291,1319,2016,5,34
287,水道二丁目,1994,3177,1599,1578,2016,5,100
288,小日向一丁目,1129,2216,1019,1197,2016,5,33
289,小日向二丁目,1090,2443,1172,1271,2016,5,18
290,小日向三丁目,657,1299,622,677,2016,5,28
291,小日向四丁目,956,1782,845,937,2016,5,31
292,大塚一丁目,534,1134,505,629,2016,5,3
293,大塚二丁目,1078,1956,828,1128,2016,5,16
294,大塚三丁目,2163,3584,1652,1932,2016,5,153
295,大塚四丁目,1815,3099,1455,1644,2016,5,50
296,大塚五丁目,2399,4344,2065,2279,2016,5,76
297,大塚六丁目,2264,3918,1965,1953,2016,5,69
298,関口一丁目,2690,4603,2147,2456,2016,5,162
299,関口二丁目,493,1019,480,539,2016,5,17
300,関口三丁目,452,926,454,472,2016,5,18
301,目白台一丁目,1231,2184,1160,1024,2016,5,39
302,目白台二丁目,1191,2190,1032,1158,2016,5,36
303,目白台三丁目,1356,2560,1180,1380,2016,5,38
304,音羽一丁目,2368,4023,1796,2227,2016,5,73
305,音羽二丁目,1016,1779,798,981,2016,5,22
306,本郷一丁目,2172,4231,1954,2277,2016,5,117
307,本郷二丁目,1883,3141,1484,1657,2016,5,147
308,本郷三丁目,1936,3012,1367,1645,2016,5,85
309,本郷四丁目,2273,4176,1986,2190,2016,5,48
310,本郷五丁目,1910,3387,1720,1667,2016,5,79
311,本郷六丁目,1098,1917,965,952,2016,5,53
312,湯島一丁目,467,684,319,365,2016,5,33
313,湯島二丁目,1689,2740,1387,1353,2016,5,92
314,湯島三丁目,1875,2875,1426,1449,2016,5,187
315,湯島四丁目,1185,2116,1065,1051,2016,5,51
316,西片一丁目,1190,2398,1135,1263,2016,5,42
317,西片二丁目,1442,2867,1418,1449,2016,5,66
318,向丘一丁目,1821,3364,1670,1694,2016,5,75
319,向丘二丁目,1883,3244,1503,1741,2016,5,100
320,弥生一丁目,234,419,209,210,2016,5,8
321,弥生二丁目,814,1514,729,785,2016,5,32
322,根津一丁目,1411,2536,1139,1397,2016,5,25
323,根津二丁目,2246,3835,1821,2014,2016,5,62
324,千駄木一丁目,715,1490,686,804,2016,5,21
325,千駄木二丁目,2540,4396,2092,2304,2016,5,80
326,千駄木三丁目,3794,6696,3192,3504,2016,5,140
327,千駄木四丁目,1667,3076,1506,1570,2016,5,78
328,千駄木五丁目,2236,4611,2225,2386,2016,5,74
329,本駒込一丁目,2349,4561,2132,2429,2016,5,142
330,本駒込二丁目,2640,5059,2447,2612,2016,5,76
331,本駒込三丁目,1836,3313,1569,1744,2016,5,70
332,本駒込四丁目,2121,4144,1981,2163,2016,5,89
333,本駒込五丁目,3113,5772,2786,2986,2016,5,129
334,本駒込六丁目,1844,3628,1674,1954,2016,5,62
335,後楽一丁目,443,725,358,367,2016,6,4
336,後楽二丁目,872,1505,755,750,2016,6,35
337,春日一丁目,965,1521,669,852,2016,6,58
338,春日二丁目,2089,4083,1959,2124,2016,6,74
339,小石川一丁目,1784,3407,1572,1835,2016,6,62
340,小石川二丁目,2124,3916,1868,2048,2016,6,69
341,小石川三丁目,2513,5197,2480,2717,2016,6,47
342,小石川四丁目,1772,3588,1640,1948,2016,6,82
343,小石川五丁目,2937,5587,2541,3046,2016,6,144
344,白山一丁目,2661,4709,2324,2385,2016,6,95
345,白山二丁目,2262,4174,2053,2121,2016,6,92
346,白山三丁目,530,1019,492,527,2016,6,24
347,白山四丁目,2263,4328,2051,2277,2016,6,52
348,白山五丁目,2146,3757,1717,2040,2016,6,100
349,千石一丁目,1890,3856,1801,2055,2016,6,48
350,千石二丁目,2056,4258,2049,2209,2016,6,43
351,千石三丁目,2183,4410,2115,2295,2016,6,74
352,千石四丁目,3270,5625,2709,2916,2016,6,156
353,水道一丁目,1409,2597,1288,1309,2016,6,49
354,水道二丁目,2064,3351,1673,1678,2016,6,118
355,小日向一丁目,1144,2233,1020,1213,2016,6,21
356,小日向二丁目,1088,2440,1172,1268,2016,6,17
357,小日向三丁目,655,1298,621,677,2016,6,31
358,小日向四丁目,953,1784,851,933,2016,6,35
359,大塚一丁目,538,1132,502,630,2016,6,1
360,大塚二丁目,1077,1963,834,1129,2016,6,24
361,大塚三丁目,2169,3591,1652,1939,2016,6,123
362,大塚四丁目,1827,3126,1462,1664,2016,6,58
363,大塚五丁目,2400,4347,2068,2279,2016,6,69
364,大塚六丁目,2262,3919,1959,1960,2016,6,55
365,関口一丁目,2719,4626,2163,2463,2016,6,137
366,関口二丁目,489,1017,479,538,2016,6,14
367,関口三丁目,455,928,454,474,2016,6,17
368,目白台一丁目,1235,2189,1162,1027,2016,6,32
369,目白台二丁目,1193,2193,1033,1160,2016,6,48
370,目白台三丁目,1361,2573,1186,1387,2016,6,39
371,音羽一丁目,2365,4019,1787,2232,2016,6,72
372,音羽二丁目,1007,1767,794,973,2016,6,21
373,本郷一丁目,2179,4250,1960,2290,2016,6,114
374,本郷二丁目,1883,3143,1486,1657,2016,6,123
375,本郷三丁目,1921,3002,1363,1639,2016,6,89
376,本郷四丁目,2264,4165,1976,2189,2016,6,58
377,本郷五丁目,1909,3389,1721,1668,2016,6,113
378,本郷六丁目,1108,1932,972,960,2016,6,49
379,湯島一丁目,466,685,320,365,2016,6,33
380,湯島二丁目,1709,2764,1401,1363,2016,6,95
381,湯島三丁目,1880,2887,1429,1458,2016,6,170
382,湯島四丁目,1185,2116,1063,1053,2016,6,60
383,西片一丁目,1187,2382,1125,1257,2016,6,45
384,西片二丁目,1442,2861,1413,1448,2016,6,52
385,向丘一丁目,1816,3365,1668,1697,2016,6,73
386,向丘二丁目,1883,3238,1498,1740,2016,6,109
387,弥生一丁目,235,421,212,209,2016,6,12
388,弥生二丁目,806,1514,731,783,2016,6,38
389,根津一丁目,1415,2538,1136,1402,2016,6,19
390,根津二丁目,2252,3840,1816,2024,2016,6,72
391,千駄木一丁目,719,1497,691,806,2016,6,18
392,千駄木二丁目,2545,4395,2097,2298,2016,6,107
393,千駄木三丁目,3784,6694,3192,3502,2016,6,118
394,千駄木四丁目,1665,3064,1501,1563,2016,6,91
395,千駄木五丁目,2239,4620,2224,2396,2016,6,95
396,本駒込一丁目,2356,4562,2135,2427,2016,6,116
397,本駒込二丁目,2644,5058,2444,2614,2016,6,56
398,本駒込三丁目,1836,3310,1575,1735,2016,6,61
399,本駒込四丁目,2119,4140,1983,2157,2016,6,107
400,本駒込五丁目,3113,5786,2786,3000,2016,6,120
401,本駒込六丁目,1846,3635,1676,1959,2016,6,57
402,後楽一丁目,440,723,356,367,2016,7,2
403,後楽二丁目,869,1496,750,746,2016,7,29
404,春日一丁目,964,1529,673,856,2016,7,55
405,春日二丁目,2097,4093,1965,2128,2016,7,72
406,小石川一丁目,1782,3411,1570,1841,2016,7,68
407,小石川二丁目,2125,3900,1859,2041,2016,7,70
408,小石川三丁目,2509,5195,2482,2713,2016,7,53
409,小石川四丁目,1775,3593,1646,1947,2016,7,79
410,小石川五丁目,2922,5572,2532,3040,2016,7,134
411,白山一丁目,2649,4698,2316,2382,2016,7,101
412,白山二丁目,2261,4184,2054,2130,2016,7,71
413,白山三丁目,526,1014,489,525,2016,7,23
414,白山四丁目,2251,4305,2039,2266,2016,7,60
415,白山五丁目,2141,3745,1713,2032,2016,7,94
416,千石一丁目,1901,3875,1810,2065,2016,7,52
417,千石二丁目,2062,4264,2051,2213,2016,7,51
418,千石三丁目,2190,4429,2121,2308,2016,7,61
419,千石四丁目,3277,5638,2713,2925,2016,7,158
420,水道一丁目,1403,2586,1282,1304,2016,7,56
421,水道二丁目,2088,3379,1688,1691,2016,7,110
422,小日向一丁目,1147,2241,1022,1219,2016,7,14
423,小日向二丁目,1094,2449,1178,1271,2016,7,16
424,小日向三丁目,658,1301,623,678,2016,7,27
425,小日向四丁目,955,1792,860,932,2016,7,28
426,大塚一丁目,541,1136,503,633,2016,7,2
427,大塚二丁目,1082,1963,829,1134,2016,7,22
428,大塚三丁目,2155,3572,1645,1927,2016,7,93
429,大塚四丁目,1836,3145,1466,1679,2016,7,48
430,大塚五丁目,2403,4351,2070,2281,2016,7,74
431,大塚六丁目,2265,3921,1966,1955,2016,7,37
432,関口一丁目,2732,4648,2170,2478,2016,7,142
433,関口二丁目,491,1022,480,542,2016,7,8
434,関口三丁目,457,927,453,474,2016,7,16
435,目白台一丁目,1240,2204,1168,1036,2016,7,42
436,目白台二丁目,1187,2188,1030,1158,2016,7,46
437,目白台三丁目,1349,2565,1184,1381,2016,7,33
438,音羽一丁目,2364,4024,1791,2233,2016,7,66
439,音羽二丁目,1011,1774,797,977,2016,7,34
440,本郷一丁目,2183,4256,1961,2295,2016,7,102
441,本郷二丁目,1896,3154,1487,1667,2016,7,107
442,本郷三丁目,1924,3011,1367,1644,2016,7,101
443,本郷四丁目,2265,4174,1978,2196,2016,7,69
444,本郷五丁目,1906,3389,1721,1668,2016,7,105
445,本郷六丁目,1111,1939,978,961,2016,7,46
446,湯島一丁目,467,686,319,367,2016,7,27
447,湯島二丁目,1708,2761,1394,1367,2016,7,124
448,湯島三丁目,1877,2886,1426,1460,2016,7,157
449,湯島四丁目,1195,2127,1069,1058,2016,7,53
450,西片一丁目,1192,2394,1132,1262,2016,7,45
451,西片二丁目,1450,2870,1424,1446,2016,7,48
452,向丘一丁目,1828,3379,1674,1705,2016,7,102
453,向丘二丁目,1882,3236,1498,1738,2016,7,100
454,弥生一丁目,238,421,212,209,2016,7,13
455,弥生二丁目,801,1514,733,781,2016,7,36
456,根津一丁目,1417,2539,1138,1401,2016,7,24
457,根津二丁目,2253,3848,1816,2032,2016,7,84
458,千駄木一丁目,726,1508,694,814,2016,7,16
459,千駄木二丁目,2547,4392,2096,2296,2016,7,117
460,千駄木三丁目,3791,6706,3200,3506,2016,7,125
461,千駄木四丁目,1670,3069,1501,1568,2016,7,79
462,千駄木五丁目,2242,4628,2229,2399,2016,7,88
463,本駒込一丁目,2356,4555,2126,2429,2016,7,95
464,本駒込二丁目,2644,5058,2440,2618,2016,7,61
465,本駒込三丁目,1833,3298,1571,1727,2016,7,64
466,本駒込四丁目,2126,4144,1983,2161,2016,7,124
467,本駒込五丁目,3105,5787,2783,3004,2016,7,137
468,本駒込六丁目,1853,3654,1685,1969,2016,7,53
469,後楽一丁目,441,726,357,369,2016,8,2
470,後楽二丁目,866,1488,745,743,2016,8,37
471,春日一丁目,965,1529,673,856,2016,8,38
472,春日二丁目,2094,4090,1962,2128,2016,8,57
473,小石川一丁目,1775,3413,1568,1845,2016,8,47
474,小石川二丁目,2126,3895,1858,2037,2016,8,70
475,小石川三丁目,2501,5183,2475,2708,2016,8,53
476,小石川四丁目,1773,3588,1639,1949,2016,8,63
477,小石川五丁目,2925,5596,2542,3054,2016,8,117
478,白山一丁目,2648,4688,2298,2390,2016,8,86
479,白山二丁目,2265,4192,2054,2138,2016,8,79
480,白山三丁目,526,1010,486,524,2016,8,25
481,白山四丁目,2238,4290,2026,2264,2016,8,53
482,白山五丁目,2148,3756,1722,2034,2016,8,79
483,千石一丁目,1899,3859,1805,2054,2016,8,65
484,千石二丁目,2070,4284,2058,2226,2016,8,49
485,千石三丁目,2206,4444,2128,2316,2016,8,48
486,千石四丁目,3266,5635,2709,2926,2016,8,170
487,水道一丁目,1407,2593,1282,1311,2016,8,48
488,水道二丁目,2089,3384,1690,1694,2016,8,116
489,小日向一丁目,1152,2256,1027,1229,2016,8,11
490,小日向二丁目,1099,2464,1183,1281,2016,8,20
491,小日向三丁目,661,1300,624,676,2016,8,21
492,小日向四丁目,955,1793,861,932,2016,8,39
493,大塚一丁目,539,1134,504,630,2016,8,1
494,大塚二丁目,1080,1960,826,1134,2016,8,55
495,大塚三丁目,2140,3560,1638,1922,2016,8,97
496,大塚四丁目,1840,3154,1470,1684,2016,8,57
497,大塚五丁目,2409,4359,2075,2284,2016,8,69
498,大塚六丁目,2289,3956,1984,1972,2016,8,45
499,関口一丁目,2747,4657,2164,2493,2016,8,143
500,関口二丁目,496,1029,484,545,2016,8,9
501,関口三丁目,457,931,454,477,2016,8,10
502,目白台一丁目,1238,2194,1164,1030,2016,8,43
503,目白台二丁目,1185,2185,1022,1163,2016,8,47
504,目白台三丁目,1347,2567,1192,1375,2016,8,46
505,音羽一丁目,2357,4013,1784,2229,2016,8,84
506,音羽二丁目,1013,1778,801,977,2016,8,33
507,本郷一丁目,2189,4271,1964,2307,2016,8,93
508,本郷二丁目,1900,3161,1494,1667,2016,8,109
509,本郷三丁目,1924,3018,1368,1650,2016,8,100
510,本郷四丁目,2267,4184,1983,2201,2016,8,78
511,本郷五丁目,1901,3380,1717,1663,2016,8,103
512,本郷六丁目,1110,1942,982,960,2016,8,51
513,湯島一丁目,462,677,319,358,2016,8,28
514,湯島二丁目,1706,2760,1394,1366,2016,8,115
515,湯島三丁目,1888,2901,1433,1468,2016,8,177
516,湯島四丁目,1202,2133,1074,1059,2016,8,57
517,西片一丁目,1199,2417,1149,1268,2016,8,42
518,西片二丁目,1461,2874,1430,1444,2016,8,46
519,向丘一丁目,1829,3379,1667,1712,2016,8,92
520,向丘二丁目,1877,3239,1503,1736,2016,8,98
521,弥生一丁目,236,419,210,209,2016,8,10
522,弥生二丁目,797,1512,732,780,2016,8,33
523,根津一丁目,1414,2539,1145,1394,2016,8,25
524,根津二丁目,2253,3854,1822,2032,2016,8,77
525,千駄木一丁目,724,1503,693,810,2016,8,19
526,千駄木二丁目,2535,4380,2094,2286,2016,8,128
527,千駄木三丁目,3788,6719,3206,3513,2016,8,153
528,千駄木四丁目,1686,3091,1510,1581,2016,8,98
529,千駄木五丁目,2246,4616,2224,2392,2016,8,77
530,本駒込一丁目,2369,4588,2137,2451,2016,8,78
531,本駒込二丁目,2652,5068,2445,2623,2016,8,59
532,本駒込三丁目,1836,3299,1576,1723,2016,8,60
533,本駒込四丁目,2129,4147,1980,2167,2016,8,109
534,本駒込五丁目,3107,5793,2789,3004,2016,8,123
535,本駒込六丁目,1852,3660,1686,1974,2016,8,58
536,後楽一丁目,440,728,359,369,2016,9,4
537,後楽二丁目,867,1493,755,738,2016,9,36
538,春日一丁目,972,1539,677,862,2016,9,34
539,春日二丁目,2088,4089,1968,2121,2016,9,56
540,小石川一丁目,1785,3427,1573,1854,2016,9,46
541,小石川二丁目,2123,3904,1859,2045,2016,9,72
542,小石川三丁目,2493,5170,2466,2704,2016,9,52
543,小石川四丁目,1788,3623,1661,1962,2016,9,54
544,小石川五丁目,2933,5626,2559,3067,2016,9,111
545,白山一丁目,2652,4689,2293,2396,2016,9,89
546,白山二丁目,2284,4206,2062,2144,2016,9,81
547,白山三丁目,528,1017,491,526,2016,9,22
548,白山四丁目,2232,4286,2034,2252,2016,9,53
549,白山五丁目,2160,3771,1733,2038,2016,9,75
550,千石一丁目,1894,3864,1804,2060,2016,9,66
551,千石二丁目,2070,4301,2065,2236,2016,9,54
552,千石三丁目,2205,4433,2124,2309,2016,9,41
553,千石四丁目,3245,5619,2696,2923,2016,9,183
554,水道一丁目,1404,2592,1280,1312,2016,9,49
555,水道二丁目,2087,3384,1681,1703,2016,9,184
556,小日向一丁目,1165,2292,1047,1245,2016,9,8
557,小日向二丁目,1093,2447,1174,1273,2016,9,21
558,小日向三丁目,657,1298,623,675,2016,9,16
559,小日向四丁目,960,1801,864,937,2016,9,27
560,大塚一丁目,539,1136,509,627,2016,9,4
561,大塚二丁目,1077,1947,820,1127,2016,9,29
562,大塚三丁目,2136,3566,1634,1932,2016,9,96
563,大塚四丁目,1843,3156,1471,1685,2016,9,72
564,大塚五丁目,2416,4359,2083,2276,2016,9,70
565,大塚六丁目,2284,3949,1986,1963,2016,9,56
566,関口一丁目,2748,4662,2170,2492,2016,9,115
567,関口二丁目,499,1034,490,544,2016,9,8
568,関口三丁目,458,943,462,481,2016,9,6
569,目白台一丁目,1206,2155,1138,1017,2016,9,31
570,目白台二丁目,1182,2180,1023,1157,2016,9,41
571,目白台三丁目,1360,2584,1200,1384,2016,9,34
572,音羽一丁目,2372,4028,1785,2243,2016,9,74
573,音羽二丁目,1005,1770,800,970,2016,9,34
574,本郷一丁目,2187,4272,1969,2303,2016,9,92
575,本郷二丁目,1906,3186,1504,1682,2016,9,107
576,本郷三丁目,1919,3008,1362,1646,2016,9,94
577,本郷四丁目,2270,4198,1989,2209,2016,9,86
578,本郷五丁目,1898,3372,1713,1659,2016,9,85
579,本郷六丁目,1117,1946,989,957,2016,9,55
580,湯島一丁目,457,670,318,352,2016,9,31
581,湯島二丁目,1698,2751,1382,1369,2016,9,106
582,湯島三丁目,1892,2905,1440,1465,2016,9,166
583,湯島四丁目,1198,2130,1072,1058,2016,9,62
584,西片一丁目,1210,2426,1155,1271,2016,9,41
585,西片二丁目,1461,2875,1440,1435,2016,9,41
586,向丘一丁目,1818,3359,1664,1695,2016,9,103
587,向丘二丁目,1883,3253,1509,1744,2016,9,91
588,弥生一丁目,238,420,208,212,2016,9,8
589,弥生二丁目,789,1501,726,775,2016,9,29
590,根津一丁目,1416,2543,1146,1397,2016,9,19
591,根津二丁目,2242,3854,1826,2028,2016,9,70
592,千駄木一丁目,724,1506,692,814,2016,9,19
593,千駄木二丁目,2528,4387,2094,2293,2016,9,105
594,千駄木三丁目,3731,6671,3185,3486,2016,9,158
595,千駄木四丁目,1685,3083,1509,1574,2016,9,70
596,千駄木五丁目,2258,4631,2225,2406,2016,9,78
597,本駒込一丁目,2377,4591,2140,2451,2016,9,68
598,本駒込二丁目,2646,5075,2449,2626,2016,9,75
599,本駒込三丁目,1834,3304,1577,1727,2016,9,54
600,本駒込四丁目,2132,4149,1983,2166,2016,9,96
601,本駒込五丁目,3109,5804,2791,3013,2016,9,119
602,本駒込六丁目,1849,3658,1685,1973,2016,9,58
603,後楽二丁目,859,1483,750,733,2016,10,45
604,春日一丁目,976,1544,679,865,2016,10,46
605,春日二丁目,2087,4085,1966,2119,2016,10,49
606,小石川一丁目,1771,3406,1563,1843,2016,10,53
607,小石川二丁目,2128,3914,1863,2051,2016,10,71
608,小石川三丁目,2521,5245,2498,2747,2016,10,61
609,小石川四丁目,1790,3619,1660,1959,2016,10,64
610,小石川五丁目,2946,5654,2570,3084,2016,10,129
611,白山一丁目,2646,4679,2287,2392,2016,10,90
612,白山二丁目,2296,4236,2080,2156,2016,10,101
613,白山三丁目,528,1019,492,527,2016,10,19
614,白山四丁目,2235,4297,2034,2263,2016,10,57
615,白山五丁目,2158,3761,1729,2032,2016,10,84
616,千石一丁目,1896,3867,1803,2064,2016,10,52
617,千石二丁目,2078,4312,2068,2244,2016,10,34
618,千石三丁目,2230,4490,2155,2335,2016,10,49
619,千石四丁目,3245,5615,2695,2920,2016,10,159
620,水道一丁目,1411,2600,1283,1317,2016,10,40
621,水道二丁目,2086,3384,1676,1708,2016,10,146
622,小日向一丁目,1169,2297,1050,1247,2016,10,9
623,小日向二丁目,1091,2447,1172,1275,2016,10,16
624,小日向三丁目,656,1288,618,670,2016,10,16
625,小日向四丁目,959,1800,859,941,2016,10,37
626,大塚一丁目,536,1132,507,625,2016,10,5
627,大塚二丁目,1089,1962,824,1138,2016,10,20
628,大塚三丁目,2133,3565,1636,1929,2016,10,83
629,大塚四丁目,1850,3150,1472,1678,2016,10,65
630,大塚五丁目,2423,4364,2078,2286,2016,10,80
631,大塚六丁目,2280,3943,1991,1952,2016,10,66
632,関口一丁目,2748,4662,2168,2494,2016,10,109
633,関口二丁目,498,1031,487,544,2016,10,11
634,関口三丁目,459,942,461,481,2016,10,7
635,目白台一丁目,1227,2175,1153,1022,2016,10,32
636,目白台二丁目,1181,2178,1025,1153,2016,10,37
637,目白台三丁目,1361,2583,1202,1381,2016,10,35
638,音羽一丁目,2385,4047,1797,2250,2016,10,86
639,音羽二丁目,1012,1768,794,974,2016,10,36
640,本郷一丁目,2201,4286,1976,2310,2016,10,72
641,本郷二丁目,1924,3213,1512,1701,2016,10,124
642,本郷三丁目,1923,3011,1365,1646,2016,10,105
643,本郷四丁目,2280,4209,1987,2222,2016,10,78
644,本郷五丁目,1909,3392,1728,1664,2016,10,79
645,本郷六丁目,1123,1960,996,964,2016,10,47
646,湯島一丁目,450,665,317,348,2016,10,26
647,湯島二丁目,1703,2750,1385,1365,2016,10,107
648,湯島三丁目,1898,2913,1450,1463,2016,10,145
649,湯島四丁目,1203,2140,1079,1061,2016,10,47
650,西片一丁目,1219,2443,1169,1274,2016,10,38
651,西片二丁目,1487,2902,1456,1446,2016,10,37
652,向丘一丁目,1825,3368,1676,1692,2016,10,85
653,向丘二丁目,1898,3265,1526,1739,2016,10,79
654,弥生一丁目,240,423,210,213,2016,10,5
655,弥生二丁目,793,1507,726,781,2016,10,31
656,根津一丁目,1421,2551,1150,1401,2016,10,19
657,根津二丁目,2250,3860,1834,2026,2016,10,65
658,千駄木一丁目,718,1498,687,811,2016,10,19
659,千駄木二丁目,2531,4396,2092,2304,2016,10,104
660,千駄木三丁目,3791,6732,3211,3521,2016,10,156
661,千駄木四丁目,1697,3097,1506,1591,2016,10,54
662,千駄木五丁目,2266,4634,2229,2405,2016,10,78
663,本駒込一丁目,2379,4591,2138,2453,2016,10,68
664,本駒込二丁目,2658,5088,2458,2630,2016,10,72
665,本駒込三丁目,1842,3314,1577,1737,2016,10,54
666,本駒込四丁目,2132,4143,1982,2161,2016,10,71
667,本駒込五丁目,3123,5822,2801,3021,2016,10,131
668,本駒込六丁目,1841,3642,1676,1966,2016,10,63
669,後楽二丁目,860,1483,748,735,2016,11,48
670,春日一丁目,975,1539,674,865,2016,11,42
671,春日二丁目,2100,4110,1981,2129,2016,11,43
672,小石川一丁目,1765,3391,1553,1838,2016,11,46
673,小石川二丁目,2124,3912,1860,2052,2016,11,66
674,小石川三丁目,2553,5291,2526,2765,2016,11,57
675,小石川四丁目,1789,3615,1655,1960,2016,11,66
676,小石川五丁目,2970,5690,2591,3099,2016,11,112
677,白山一丁目,2646,4680,2285,2395,2016,11,97
678,白山二丁目,2295,4240,2082,2158,2016,11,91
679,白山三丁目,527,1017,491,526,2016,11,24
680,白山四丁目,2232,4292,2033,2259,2016,11,54
681,白山五丁目,2151,3755,1725,2030,2016,11,73
682,千石一丁目,1905,3883,1812,2071,2016,11,51
683,千石二丁目,2106,4352,2094,2258,2016,11,29
684,千石三丁目,2234,4496,2159,2337,2016,11,55
685,千石四丁目,3258,5641,2708,2933,2016,11,154
686,水道一丁目,1411,2606,1288,1318,2016,11,70
687,水道二丁目,2101,3415,1685,1730,2016,11,126
688,小日向一丁目,1167,2298,1049,1249,2016,11,11
689,小日向二丁目,1089,2444,1172,1272,2016,11,21
690,小日向三丁目,656,1282,614,668,2016,11,18
691,小日向四丁目,961,1806,857,949,2016,11,45
692,大塚一丁目,533,1123,501,622,2016,11,6
693,大塚二丁目,1096,1972,832,1140,2016,11,14
694,大塚三丁目,2141,3571,1638,1933,2016,11,121
695,大塚四丁目,1852,3152,1473,1679,2016,11,62
696,大塚五丁目,2421,4361,2081,2280,2016,11,88
697,大塚六丁目,2275,3940,1990,1950,2016,11,67
698,関口一丁目,2757,4678,2172,2506,2016,11,105
699,関口二丁目,498,1028,483,545,2016,11,7
700,関口三丁目,459,943,463,480,2016,11,7
701,目白台一丁目,1235,2177,1156,1021,2016,11,31
702,目白台二丁目,1184,2177,1024,1153,2016,11,45
703,目白台三丁目,1361,2585,1199,1386,2016,11,35
704,音羽一丁目,2380,4052,1807,2245,2016,11,79
705,音羽二丁目,1012,1767,791,976,2016,11,40
706,本郷一丁目,2208,4298,1992,2306,2016,11,63
707,本郷二丁目,1927,3217,1513,1704,2016,11,106
708,本郷三丁目,1921,3010,1367,1643,2016,11,94
709,本郷四丁目,2284,4202,1981,2221,2016,11,69
710,本郷五丁目,1918,3403,1731,1672,2016,11,70
711,本郷六丁目,1128,1971,1009,962,2016,11,52
712,湯島一丁目,446,660,318,342,2016,11,29
713,湯島二丁目,1691,2742,1383,1359,2016,11,105
714,湯島三丁目,1900,2922,1456,1466,2016,11,133
715,湯島四丁目,1207,2149,1086,1063,2016,11,45
716,西片一丁目,1228,2451,1171,1280,2016,11,27
717,西片二丁目,1489,2908,1458,1450,2016,11,41
718,向丘一丁目,1828,3361,1681,1680,2016,11,76
719,向丘二丁目,1901,3263,1531,1732,2016,11,68
720,弥生一丁目,243,426,214,212,2016,11,3
721,弥生二丁目,797,1510,728,782,2016,11,27
722,根津一丁目,1432,2563,1152,1411,2016,11,24
723,根津二丁目,2251,3861,1829,2032,2016,11,73
724,千駄木一丁目,722,1506,691,815,2016,11,21
725,千駄木二丁目,2518,4377,2085,2292,2016,11,112
726,千駄木三丁目,3783,6722,3208,3514,2016,11,160
727,千駄木四丁目,1704,3109,1510,1599,2016,11,43
728,千駄木五丁目,2273,4639,2227,2412,2016,11,41
729,本駒込一丁目,2372,4605,2145,2460,2016,11,78
730,本駒込二丁目,2658,5090,2462,2628,2016,11,67
731,本駒込三丁目,1836,3306,1578,1728,2016,11,55
732,本駒込四丁目,2139,4152,1979,2173,2016,11,76
733,本駒込五丁目,3131,5834,2808,3026,2016,11,137
734,本駒込六丁目,1838,3633,1675,1958,2016,11,64
735,後楽一丁目,457,745,368,377,2016,12,2
736,後楽二丁目,854,1483,744,739,2016,12,48
737,春日一丁目,973,1536,673,863,2016,12,39
738,春日二丁目,2101,4102,1971,2131,2016,12,48
739,小石川一丁目,1787,3427,1570,1857,2016,12,38
740,小石川二丁目,2132,3909,1859,2050,2016,12,48
741,小石川三丁目,2565,5311,2540,2771,2016,12,55
742,小石川四丁目,1800,3649,1671,1978,2016,12,51
743,小石川五丁目,2982,5703,2592,3111,2016,12,99
744,白山一丁目,2638,4665,2280,2385,2016,12,100
745,白山二丁目,2301,4254,2082,2172,2016,12,108
746,白山三丁目,532,1024,492,532,2016,12,19
747,白山四丁目,2233,4295,2039,2256,2016,12,64
748,白山五丁目,2151,3766,1730,2036,2016,12,82
749,千石一丁目,1906,3881,1806,2075,2016,12,47
750,千石二丁目,2105,4358,2099,2259,2016,12,46
751,千石三丁目,2227,4496,2160,2336,2016,12,47
752,千石四丁目,3258,5645,2712,2933,2016,12,151
753,水道一丁目,1404,2587,1282,1305,2016,12,80
754,水道二丁目,2111,3428,1696,1732,2016,12,133
755,小日向一丁目,1162,2294,1053,1241,2016,12,12
756,小日向二丁目,1085,2438,1167,1271,2016,12,23
757,小日向三丁目,652,1271,611,660,2016,12,21
758,小日向四丁目,959,1804,857,947,2016,12,53
759,大塚一丁目,533,1121,499,622,2016,12,2
760,大塚二丁目,1101,1979,837,1142,2016,12,18
761,大塚三丁目,2138,3575,1640,1935,2016,12,96
762,大塚四丁目,1843,3151,1472,1679,2016,12,55
763,大塚五丁目,2406,4335,2066,2269,2016,12,73
764,大塚六丁目,2268,3927,1982,1945,2016,12,77
765,関口一丁目,2758,4670,2175,2495,2016,12,123
766,関口二丁目,496,1029,484,545,2016,12,9
767,関口三丁目,456,941,462,479,2016,12,27
768,目白台一丁目,1234,2168,1146,1022,2016,12,31
769,目白台二丁目,1190,2180,1028,1152,2016,12,24
770,目白台三丁目,1361,2583,1197,1386,2016,12,32
771,音羽一丁目,2382,4054,1809,2245,2016,12,72
772,音羽二丁目,1013,1770,794,976,2016,12,30
773,本郷一丁目,2208,4299,1990,2309,2016,12,66
774,本郷二丁目,1926,3228,1528,1700,2016,12,84
775,本郷三丁目,1919,3006,1369,1637,2016,12,90
776,本郷四丁目,2278,4196,1979,2217,2016,12,61
777,本郷五丁目,1917,3389,1724,1665,2016,12,68
778,本郷六丁目,1128,1972,1007,965,2016,12,45
779,湯島一丁目,447,664,316,348,2016,12,34
780,湯島二丁目,1687,2738,1379,1359,2016,12,90
781,湯島三丁目,1889,2912,1452,1460,2016,12,99
782,湯島四丁目,1208,2148,1091,1057,2016,12,49
783,西片一丁目,1224,2444,1168,1276,2016,12,29
784,西片二丁目,1482,2895,1455,1440,2016,12,33
785,向丘一丁目,1825,3369,1687,1682,2016,12,82
786,向丘二丁目,1900,3255,1531,1724,2016,12,64
787,弥生一丁目,245,433,217,216,2016,12,5
788,弥生二丁目,799,1509,733,776,2016,12,28
789,根津一丁目,1437,2569,1150,1419,2016,12,22
790,根津二丁目,2255,3866,1834,2032,2016,12,61
791,千駄木一丁目,720,1500,687,813,2016,12,21
792,千駄木二丁目,2535,4401,2096,2305,2016,12,101
793,千駄木三丁目,3771,6702,3197,3505,2016,12,177
794,千駄木四丁目,1702,3108,1507,1601,2016,12,41
795,千駄木五丁目,2281,4654,2232,2422,2016,12,43
796,本駒込一丁目,2377,4619,2150,2469,2016,12,59
797,本駒込二丁目,2656,5089,2459,2630,2016,12,68
798,本駒込三丁目,1831,3302,1579,1723,2016,12,60
799,本駒込四丁目,2143,4158,1988,2170,2016,12,83
800,本駒込五丁目,3116,5823,2800,3023,2016,12,134
801,本駒込六丁目,1841,3655,1693,1962,2016,12,51
802,後楽一丁目,536,827,443,384,2015,1,6
803,後楽二丁目,817,1457,730,727,2015,1,57
804,春日一丁目,968,1539,704,835,2015,1,46
805,春日二丁目,2041,3998,1914,2084,2015,1,92
806,小石川一丁目,2000,3723,1717,2006,2015,1,71
807,小石川二丁目,2111,3878,1832,2046,2015,1,99
808,小石川三丁目,2449,5025,2385,2640,2015,1,85
809,小石川四丁目,1679,3332,1511,1821,2015,1,84
810,小石川五丁目,2896,5548,2546,3002,2015,1,138
811,白山一丁目,2558,4598,2256,2342,2015,1,105
812,白山二丁目,2174,4041,1979,2062,2015,1,155
813,白山三丁目,528,1029,502,527,2015,1,10
814,白山四丁目,2221,4311,2055,2256,2015,1,84
815,白山五丁目,2044,3660,1672,1988,2015,1,130
816,千石一丁目,1883,3853,1813,2040,2015,1,67
817,千石二丁目,1918,3891,1852,2039,2015,1,67
818,千石三丁目,2150,4349,2093,2256,2015,1,66
819,千石四丁目,3081,5374,2577,2797,2015,1,197
820,水道一丁目,1372,2543,1246,1297,2015,1,75
821,水道二丁目,1889,3013,1524,1489,2015,1,158
822,小日向一丁目,1127,2199,998,1201,2015,1,21
823,小日向二丁目,1064,2383,1142,1241,2015,1,37
824,小日向三丁目,649,1302,628,674,2015,1,23
825,小日向四丁目,967,1821,861,960,2015,1,31
826,大塚一丁目,557,1180,552,628,2015,1,8
827,大塚二丁目,1040,1921,820,1101,2015,1,17
828,大塚三丁目,1990,3361,1553,1808,2015,1,155
829,大塚四丁目,1775,3039,1425,1614,2015,1,73
830,大塚五丁目,2345,4257,2025,2232,2015,1,90
831,大塚六丁目,2167,3763,1891,1872,2015,1,83
832,関口一丁目,2484,4226,1967,2259,2015,1,132
833,関口二丁目,476,995,463,532,2015,1,29
834,関口三丁目,435,888,429,459,2015,1,26
835,目白台一丁目,1287,2229,1227,1002,2015,1,41
836,目白台二丁目,1158,2127,998,1129,2015,1,100
837,目白台三丁目,1331,2555,1203,1352,2015,1,35
838,音羽一丁目,2343,3953,1759,2194,2015,1,88
839,音羽二丁目,976,1759,767,992,2015,1,35
840,本郷一丁目,2117,4137,1911,2226,2015,1,76
841,本郷二丁目,1712,2898,1365,1533,2015,1,108
842,本郷三丁目,1886,2970,1386,1584,2015,1,97
843,本郷四丁目,2213,4011,1901,2110,2015,1,70
844,本郷五丁目,1853,3293,1689,1604,2015,1,42
845,本郷六丁目,1097,1898,963,935,2015,1,86
846,湯島一丁目,466,693,322,371,2015,1,29
847,湯島二丁目,1570,2608,1321,1287,2015,1,90
848,湯島三丁目,1791,2784,1375,1409,2015,1,179
849,湯島四丁目,1118,2003,1011,992,2015,1,43
850,西片一丁目,1191,2389,1120,1269,2015,1,46
851,西片二丁目,1442,2903,1450,1453,2015,1,53
852,向丘一丁目,1783,3261,1639,1622,2015,1,89
853,向丘二丁目,1845,3212,1515,1697,2015,1,76
854,弥生一丁目,236,422,215,207,2015,1,15
855,弥生二丁目,825,1559,755,804,2015,1,26
856,根津一丁目,1401,2507,1111,1396,2015,1,32
857,根津二丁目,2162,3729,1770,1959,2015,1,54
858,千駄木一丁目,709,1465,681,784,2015,1,18
859,千駄木二丁目,2458,4336,2036,2300,2015,1,122
860,千駄木三丁目,3692,6593,3146,3447,2015,1,156
861,千駄木四丁目,1580,2958,1479,1479,2015,1,70
862,千駄木五丁目,2237,4593,2204,2389,2015,1,78
863,本駒込一丁目,2318,4517,2129,2388,2015,1,112
864,本駒込二丁目,2563,4877,2345,2532,2015,1,113
865,本駒込三丁目,1806,3248,1553,1695,2015,1,70
866,本駒込四丁目,2121,4151,2008,2143,2015,1,87
867,本駒込五丁目,2999,5610,2694,2916,2015,1,201
868,本駒込六丁目,1742,3402,1542,1860,2015,1,66
869,後楽一丁目,474,767,382,385,2015,2,8
870,後楽二丁目,820,1460,733,727,2015,2,55
871,春日一丁目,974,1552,709,843,2015,2,62
872,春日二丁目,2042,4007,1923,2084,2015,2,105
873,小石川一丁目,1999,3715,1712,2003,2015,2,74
874,小石川二丁目,2114,3890,1843,2047,2015,2,80
875,小石川三丁目,2444,5019,2378,2641,2015,2,75
876,小石川四丁目,1680,3340,1518,1822,2015,2,80
877,小石川五丁目,2902,5554,2552,3002,2015,2,120
878,白山一丁目,2562,4598,2256,2342,2015,2,105
879,白山二丁目,2177,4059,1985,2074,2015,2,137
880,白山三丁目,527,1027,499,528,2015,2,22
881,白山四丁目,2226,4322,2064,2258,2015,2,89
882,白山五丁目,2056,3670,1683,1987,2015,2,118
883,千石一丁目,1882,3852,1811,2041,2015,2,59
884,千石二丁目,1923,3889,1855,2034,2015,2,61
885,千石三丁目,2140,4325,2086,2239,2015,2,67
886,千石四丁目,3084,5371,2578,2793,2015,2,175
887,水道一丁目,1381,2550,1252,1298,2015,2,71
888,水道二丁目,1884,3010,1521,1489,2015,2,130
889,小日向一丁目,1124,2195,999,1196,2015,2,22
890,小日向二丁目,1069,2387,1139,1248,2015,2,36
891,小日向三丁目,649,1303,627,676,2015,2,31
892,小日向四丁目,968,1829,862,967,2015,2,27
893,大塚一丁目,554,1174,547,627,2015,2,6
894,大塚二丁目,1037,1923,823,1100,2015,2,17
895,大塚三丁目,1985,3357,1552,1805,2015,2,128
896,大塚四丁目,1789,3051,1432,1619,2015,2,62
897,大塚五丁目,2348,4270,2030,2240,2015,2,86
898,大塚六丁目,2155,3753,1881,1872,2015,2,76
899,関口一丁目,2519,4290,2003,2287,2015,2,153
900,関口二丁目,479,1000,466,534,2015,2,21
901,関口三丁目,438,893,430,463,2015,2,18
902,目白台一丁目,1281,2226,1216,1010,2015,2,41
903,目白台二丁目,1165,2132,995,1137,2015,2,82
904,目白台三丁目,1339,2559,1210,1349,2015,2,34
905,音羽一丁目,2336,3945,1755,2190,2015,2,81
906,音羽二丁目,971,1747,764,983,2015,2,32
907,本郷一丁目,2113,4134,1907,2227,2015,2,74
908,本郷二丁目,1732,2924,1375,1549,2015,2,98
909,本郷三丁目,1884,2964,1385,1579,2015,2,97
910,本郷四丁目,2212,4015,1903,2112,2015,2,86
911,本郷五丁目,1855,3287,1684,1603,2015,2,67
912,本郷六丁目,1094,1894,966,928,2015,2,72
913,湯島一丁目,466,694,323,371,2015,2,32
914,湯島二丁目,1577,2610,1317,1293,2015,2,112
915,湯島三丁目,1801,2801,1381,1420,2015,2,135
916,湯島四丁目,1153,2075,1044,1031,2015,2,45
917,西片一丁目,1193,2394,1123,1271,2015,2,43
918,西片二丁目,1444,2910,1448,1462,2015,2,76
919,向丘一丁目,1788,3269,1646,1623,2015,2,88
920,向丘二丁目,1842,3207,1521,1686,2015,2,105
921,弥生一丁目,237,423,216,207,2015,2,17
922,弥生二丁目,835,1569,759,810,2015,2,35
923,根津一丁目,1392,2490,1103,1387,2015,2,22
924,根津二丁目,2160,3735,1773,1962,2015,2,68
925,千駄木一丁目,713,1467,680,787,2015,2,13
926,千駄木二丁目,2463,4340,2043,2297,2015,2,114
927,千駄木三丁目,3680,6595,3149,3446,2015,2,161
928,千駄木四丁目,1593,2978,1490,1488,2015,2,73
929,千駄木五丁目,2231,4590,2202,2388,2015,2,88
930,本駒込一丁目,2316,4528,2132,2396,2015,2,118
931,本駒込二丁目,2577,4897,2352,2545,2015,2,102
932,本駒込三丁目,1800,3238,1549,1689,2015,2,69
933,本駒込四丁目,2121,4151,2007,2144,2015,2,103
934,本駒込五丁目,3008,5618,2687,2931,2015,2,187
935,本駒込六丁目,1741,3409,1546,1863,2015,2,71
936,後楽一丁目,447,738,354,384,2015,3,13
937,後楽二丁目,817,1457,734,723,2015,3,65
938,春日一丁目,982,1563,712,851,2015,3,68
939,春日二丁目,2031,3989,1909,2080,2015,3,78
940,小石川一丁目,2000,3725,1718,2007,2015,3,89
941,小石川二丁目,2111,3888,1843,2045,2015,3,70
942,小石川三丁目,2439,5019,2375,2644,2015,3,79
943,小石川四丁目,1689,3356,1527,1829,2015,3,61
944,小石川五丁目,2903,5556,2554,3002,2015,3,113
945,白山一丁目,2572,4603,2256,2347,2015,3,134
946,白山二丁目,2184,4065,1989,2076,2015,3,164
947,白山三丁目,528,1032,499,533,2015,3,21
948,白山四丁目,2225,4315,2069,2246,2015,3,88
949,白山五丁目,2065,3686,1689,1997,2015,3,129
950,千石一丁目,1880,3856,1818,2038,2015,3,67
951,千石二丁目,1919,3894,1858,2036,2015,3,69
952,千石三丁目,2148,4336,2089,2247,2015,3,57
953,千石四丁目,3086,5384,2587,2797,2015,3,211
954,水道一丁目,1384,2553,1257,1296,2015,3,62
955,水道二丁目,1888,3020,1528,1492,2015,3,134
956,小日向一丁目,1129,2209,1005,1204,2015,3,23
957,小日向二丁目,1070,2388,1143,1245,2015,3,31
958,小日向三丁目,645,1298,621,677,2015,3,30
959,小日向四丁目,971,1835,862,973,2015,3,35
960,大塚一丁目,552,1170,546,624,2015,3,2
961,大塚二丁目,1016,1900,818,1082,2015,3,18
962,大塚三丁目,1991,3367,1563,1804,2015,3,178
963,大塚四丁目,1778,3034,1422,1612,2015,3,96
964,大塚五丁目,2359,4299,2039,2260,2015,3,94
965,大塚六丁目,2155,3747,1877,1870,2015,3,74
966,関口一丁目,2551,4333,2024,2309,2015,3,155
967,関口二丁目,480,1003,469,534,2015,3,18
968,関口三丁目,447,909,435,474,2015,3,26
969,目白台一丁目,1255,2201,1195,1006,2015,3,46
970,目白台二丁目,1152,2117,990,1127,2015,3,61
971,目白台三丁目,1342,2569,1212,1357,2015,3,36
972,音羽一丁目,2345,3959,1766,2193,2015,3,90
973,音羽二丁目,973,1744,763,981,2015,3,33
974,本郷一丁目,2122,4143,1913,2230,2015,3,96
975,本郷二丁目,1741,2935,1377,1558,2015,3,135
976,本郷三丁目,1899,2984,1392,1592,2015,3,99
977,本郷四丁目,2203,3992,1899,2093,2015,3,100
978,本郷五丁目,1853,3287,1683,1604,2015,3,64
979,本郷六丁目,1087,1889,967,922,2015,3,83
980,湯島一丁目,465,690,320,370,2015,3,41
981,湯島二丁目,1574,2614,1316,1298,2015,3,113
982,湯島三丁目,1816,2824,1394,1430,2015,3,157
983,湯島四丁目,1158,2080,1046,1034,2015,3,69
984,西片一丁目,1196,2402,1128,1274,2015,3,37
985,西片二丁目,1438,2894,1441,1453,2015,3,72
986,向丘一丁目,1784,3266,1644,1622,2015,3,127
987,向丘二丁目,1832,3200,1517,1683,2015,3,107
988,弥生一丁目,236,421,215,206,2015,3,31
989,弥生二丁目,827,1568,764,804,2015,3,26
990,根津一丁目,1392,2491,1109,1382,2015,3,35
991,根津二丁目,2179,3755,1783,1972,2015,3,72
992,千駄木一丁目,718,1479,686,793,2015,3,15
993,千駄木二丁目,2462,4336,2039,2297,2015,3,155
994,千駄木三丁目,3677,6606,3154,3452,2015,3,166
995,千駄木四丁目,1589,2978,1494,1484,2015,3,75
996,千駄木五丁目,2238,4591,2206,2385,2015,3,103
997,本駒込一丁目,2310,4526,2135,2391,2015,3,150
998,本駒込二丁目,2578,4911,2363,2548,2015,3,115
999,本駒込三丁目,1800,3235,1547,1688,2015,3,83
1000,本駒込四丁目,2117,4151,2010,2141,2015,3,118
1001,本駒込五丁目,3004,5619,2690,2929,2015,3,189
1002,本駒込六丁目,1739,3414,1554,1860,2015,3,93
1003,後楽一丁目,441,728,350,378,2015,4,8
1004,後楽二丁目,805,1434,723,711,2015,4,56
1005,春日一丁目,986,1571,722,849,2015,4,66
1006,春日二丁目,2043,4023,1930,2093,2015,4,55
1007,小石川一丁目,2002,3714,1710,2004,2015,4,83
1008,小石川二丁目,2126,3894,1846,2048,2015,4,63
1009,小石川三丁目,2453,5054,2387,2667,2015,4,73
1010,小石川四丁目,1696,3377,1539,1838,2015,4,55
1011,小石川五丁目,2914,5577,2562,3015,2015,4,116
1012,白山一丁目,2601,4659,2276,2383,2015,4,130
1013,白山二丁目,2199,4073,2008,2065,2015,4,130
1014,白山三丁目,529,1030,503,527,2015,4,16
1015,白山四丁目,2234,4321,2063,2258,2015,4,75
1016,白山五丁目,2102,3735,1721,2014,2015,4,110
1017,千石一丁目,1884,3862,1819,2043,2015,4,49
1018,千石二丁目,1940,3954,1897,2057,2015,4,66
1019,千石三丁目,2148,4320,2071,2249,2015,4,39
1020,千石四丁目,3144,5444,2594,2850,2015,4,187
1021,水道一丁目,1384,2551,1256,1295,2015,4,66
1022,水道二丁目,1923,3064,1548,1516,2015,4,112
1023,小日向一丁目,1134,2218,1016,1202,2015,4,27
1024,小日向二丁目,1072,2382,1139,1243,2015,4,46
1025,小日向三丁目,649,1300,618,682,2015,4,23
1026,小日向四丁目,966,1816,854,962,2015,4,34
1027,大塚一丁目,545,1157,540,617,2015,4,1
1028,大塚二丁目,1028,1911,820,1091,2015,4,10
1029,大塚三丁目,2024,3408,1585,1823,2015,4,149
1030,大塚四丁目,1772,3025,1414,1611,2015,4,76
1031,大塚五丁目,2369,4304,2043,2261,2015,4,89
1032,大塚六丁目,2156,3746,1876,1870,2015,4,81
1033,関口一丁目,2560,4348,2030,2318,2015,4,157
1034,関口二丁目,482,1005,470,535,2015,4,13
1035,関口三丁目,443,897,430,467,2015,4,20
1036,目白台一丁目,1237,2190,1173,1017,2015,4,44
1037,目白台二丁目,1166,2125,986,1139,2015,4,31
1038,目白台三丁目,1325,2550,1197,1353,2015,4,48
1039,音羽一丁目,2349,3955,1769,2186,2015,4,85
1040,音羽二丁目,972,1733,759,974,2015,4,40
1041,本郷一丁目,2117,4131,1908,2223,2015,4,88
1042,本郷二丁目,1774,2976,1398,1578,2015,4,105
1043,本郷三丁目,1922,2999,1393,1606,2015,4,90
1044,本郷四丁目,2194,3972,1893,2079,2015,4,89
1045,本郷五丁目,1858,3305,1688,1617,2015,4,66
1046,本郷六丁目,1077,1873,949,924,2015,4,76
1047,湯島一丁目,473,692,321,371,2015,4,32
1048,湯島二丁目,1587,2641,1334,1307,2015,4,108
1049,湯島三丁目,1841,2847,1404,1443,2015,4,139
1050,湯島四丁目,1163,2099,1053,1046,2015,4,60
1051,西片一丁目,1190,2394,1123,1271,2015,4,31
1052,西片二丁目,1432,2882,1433,1449,2015,4,57
1053,向丘一丁目,1777,3254,1617,1637,2015,4,97
1054,向丘二丁目,1854,3219,1502,1717,2015,4,100
1055,弥生一丁目,231,415,211,204,2015,4,18
1056,弥生二丁目,828,1573,764,809,2015,4,38
1057,根津一丁目,1386,2495,1113,1382,2015,4,33
1058,根津二丁目,2167,3733,1776,1957,2015,4,76
1059,千駄木一丁目,724,1488,687,801,2015,4,15
1060,千駄木二丁目,2491,4355,2047,2308,2015,4,130
1061,千駄木三丁目,3740,6682,3174,3508,2015,4,181
1062,千駄木四丁目,1592,2979,1486,1493,2015,4,63
1063,千駄木五丁目,2259,4625,2227,2398,2015,4,102
1064,本駒込一丁目,2319,4523,2134,2389,2015,4,159
1065,本駒込二丁目,2545,4888,2353,2535,2015,4,83
1066,本駒込三丁目,1826,3279,1563,1716,2015,4,74
1067,本駒込四丁目,2117,4148,1999,2149,2015,4,97
1068,本駒込五丁目,3019,5669,2727,2942,2015,4,180
1069,本駒込六丁目,1772,3457,1566,1891,2015,4,105
1070,後楽一丁目,449,738,354,384,2015,5,10
1071,後楽二丁目,828,1461,729,732,2015,5,52
1072,春日一丁目,981,1557,714,843,2015,5,71
1073,春日二丁目,2045,4019,1927,2092,2015,5,60
1074,小石川一丁目,1997,3699,1708,1991,2015,5,86
1075,小石川二丁目,2126,3886,1842,2044,2015,5,57
1076,小石川三丁目,2492,5119,2422,2697,2015,5,65
1077,小石川四丁目,1704,3391,1541,1850,2015,5,66
1078,小石川五丁目,2934,5593,2569,3024,2015,5,137
1079,白山一丁目,2602,4635,2267,2368,2015,5,126
1080,白山二丁目,2202,4075,2004,2071,2015,5,114
1081,白山三丁目,530,1024,499,525,2015,5,16
1082,白山四丁目,2242,4322,2060,2262,2015,5,74
1083,白山五丁目,2108,3744,1726,2018,2015,5,124
1084,千石一丁目,1900,3880,1830,2050,2015,5,49
1085,千石二丁目,1980,4057,1951,2106,2015,5,62
1086,千石三丁目,2141,4312,2068,2244,2015,5,46
1087,千石四丁目,3153,5489,2625,2864,2015,5,191
1088,水道一丁目,1382,2547,1254,1293,2015,5,61
1089,水道二丁目,1931,3077,1559,1518,2015,5,131
1090,小日向一丁目,1140,2222,1018,1204,2015,5,28
1091,小日向二丁目,1068,2375,1142,1233,2015,5,38
1092,小日向三丁目,652,1306,625,681,2015,5,14
1093,小日向四丁目,966,1817,857,960,2015,5,47
1094,大塚一丁目,544,1155,530,625,2015,5,1
1095,大塚二丁目,1044,1922,823,1099,2015,5,13
1096,大塚三丁目,2028,3400,1584,1816,2015,5,141
1097,大塚四丁目,1779,3038,1422,1616,2015,5,68
1098,大塚五丁目,2378,4314,2045,2269,2015,5,77
1099,大塚六丁目,2198,3810,1904,1906,2015,5,63
1100,関口一丁目,2579,4369,2047,2322,2015,5,142
1101,関口二丁目,485,1008,474,534,2015,5,4
1102,関口三丁目,445,901,434,467,2015,5,13
1103,目白台一丁目,1266,2219,1200,1019,2015,5,45
1104,目白台二丁目,1169,2124,989,1135,2015,5,22
1105,目白台三丁目,1337,2564,1196,1368,2015,5,44
1106,音羽一丁目,2354,3976,1785,2191,2015,5,98
1107,音羽二丁目,972,1728,758,970,2015,5,44
1108,本郷一丁目,2129,4140,1915,2225,2015,5,101
1109,本郷二丁目,1788,3006,1418,1588,2015,5,75
1110,本郷三丁目,1928,3004,1392,1612,2015,5,80
1111,本郷四丁目,2188,3968,1891,2077,2015,5,77
1112,本郷五丁目,1869,3309,1693,1616,2015,5,87
1113,本郷六丁目,1090,1878,946,932,2015,5,71
1114,湯島一丁目,476,690,322,368,2015,5,32
1115,湯島二丁目,1607,2672,1352,1320,2015,5,94
1116,湯島三丁目,1852,2858,1411,1447,2015,5,145
1117,湯島四丁目,1175,2104,1060,1044,2015,5,48
1118,西片一丁目,1184,2385,1125,1260,2015,5,34
1119,西片二丁目,1448,2903,1442,1461,2015,5,58
1120,向丘一丁目,1807,3281,1634,1647,2015,5,89
1121,向丘二丁目,1849,3210,1498,1712,2015,5,86
1122,弥生一丁目,229,412,208,204,2015,5,15
1123,弥生二丁目,822,1562,757,805,2015,5,29
1124,根津一丁目,1381,2487,1105,1382,2015,5,27
1125,根津二丁目,2191,3765,1802,1963,2015,5,80
1126,千駄木一丁目,722,1486,686,800,2015,5,22
1127,千駄木二丁目,2504,4361,2053,2308,2015,5,131
1128,千駄木三丁目,3788,6733,3203,3530,2015,5,174
1129,千駄木四丁目,1613,3001,1498,1503,2015,5,49
1130,千駄木五丁目,2258,4606,2221,2385,2015,5,91
1131,本駒込一丁目,2321,4524,2135,2389,2015,5,138
1132,本駒込二丁目,2597,4947,2404,2543,2015,5,98
1133,本駒込三丁目,1817,3270,1556,1714,2015,5,68
1134,本駒込四丁目,2115,4142,2000,2142,2015,5,92
1135,本駒込五丁目,3060,5713,2743,2970,2015,5,174
1136,本駒込六丁目,1774,3488,1587,1901,2015,5,115
1137,後楽一丁目,454,739,359,380,2015,6,6
1138,後楽二丁目,825,1457,722,735,2015,6,55
1139,春日一丁目,980,1553,711,842,2015,6,67
1140,春日二丁目,2050,4029,1926,2103,2015,6,74
1141,小石川一丁目,1991,3686,1698,1988,2015,6,88
1142,小石川二丁目,2131,3903,1852,2051,2015,6,69
1143,小石川三丁目,2495,5132,2427,2705,2015,6,60
1144,小石川四丁目,1695,3388,1538,1850,2015,6,63
1145,小石川五丁目,2931,5588,2567,3021,2015,6,123
1146,白山一丁目,2612,4650,2277,2373,2015,6,135
1147,白山二丁目,2204,4084,2005,2079,2015,6,98
1148,白山三丁目,529,1018,495,523,2015,6,14
1149,白山四丁目,2248,4316,2051,2265,2015,6,68
1150,白山五丁目,2110,3761,1731,2030,2015,6,122
1151,千石一丁目,1901,3888,1831,2057,2015,6,52
1152,千石二丁目,1986,4080,1963,2117,2015,6,60
1153,千石三丁目,2123,4287,2051,2236,2015,6,46
1154,千石四丁目,3164,5497,2624,2873,2015,6,166
1155,水道一丁目,1375,2546,1252,1294,2015,6,74
1156,水道二丁目,1917,3063,1554,1509,2015,6,110
1157,小日向一丁目,1141,2221,1012,1209,2015,6,19
1158,小日向二丁目,1067,2379,1143,1236,2015,6,39
1159,小日向三丁目,651,1303,621,682,2015,6,11
1160,小日向四丁目,965,1809,855,954,2015,6,47
1161,大塚一丁目,552,1162,537,625,2015,6,2
1162,大塚二丁目,1043,1920,818,1102,2015,6,10
1163,大塚三丁目,2036,3414,1585,1829,2015,6,150
1164,大塚四丁目,1775,3041,1420,1621,2015,6,72
1165,大塚五丁目,2377,4315,2052,2263,2015,6,67
1166,大塚六丁目,2208,3823,1911,1912,2015,6,54
1167,関口一丁目,2593,4392,2052,2340,2015,6,122
1168,関口二丁目,488,1014,477,537,2015,6,3
1169,関口三丁目,446,901,436,465,2015,6,10
1170,目白台一丁目,1263,2219,1196,1023,2015,6,46
1171,目白台二丁目,1172,2134,994,1140,2015,6,14
1172,目白台三丁目,1336,2554,1186,1368,2015,6,45
1173,音羽一丁目,2351,3989,1788,2201,2015,6,111
1174,音羽二丁目,975,1733,759,974,2015,6,56
1175,本郷一丁目,2126,4132,1910,2222,2015,6,91
1176,本郷二丁目,1807,3026,1430,1596,2015,6,96
1177,本郷三丁目,1921,2993,1379,1614,2015,6,95
1178,本郷四丁目,2177,3956,1882,2074,2015,6,83
1179,本郷五丁目,1873,3308,1693,1615,2015,6,70
1180,本郷六丁目,1086,1872,942,930,2015,6,73
1181,湯島一丁目,472,687,320,367,2015,6,41
1182,湯島二丁目,1615,2681,1357,1324,2015,6,92
1183,湯島三丁目,1850,2848,1406,1442,2015,6,166
1184,湯島四丁目,1184,2128,1074,1054,2015,6,52
1185,西片一丁目,1183,2387,1128,1259,2015,6,26
1186,西片二丁目,1440,2882,1431,1451,2015,6,59
1187,向丘一丁目,1807,3283,1637,1646,2015,6,87
1188,向丘二丁目,1859,3225,1506,1719,2015,6,97
1189,弥生一丁目,231,415,207,208,2015,6,11
1190,弥生二丁目,819,1565,758,807,2015,6,32
1191,根津一丁目,1385,2494,1110,1384,2015,6,23
1192,根津二丁目,2191,3761,1800,1961,2015,6,81
1193,千駄木一丁目,719,1493,687,806,2015,6,22
1194,千駄木二丁目,2508,4364,2060,2304,2015,6,139
1195,千駄木三丁目,3800,6755,3217,3538,2015,6,149
1196,千駄木四丁目,1609,2999,1499,1500,2015,6,56
1197,千駄木五丁目,2263,4621,2233,2388,2015,6,71
1198,本駒込一丁目,2317,4515,2129,2386,2015,6,113
1199,本駒込二丁目,2588,4917,2390,2527,2015,6,115
1200,本駒込三丁目,1820,3273,1559,1714,2015,6,85
1201,本駒込四丁目,2119,4149,2003,2146,2015,6,105
1202,本駒込五丁目,3055,5715,2742,2973,2015,6,170
1203,本駒込六丁目,1785,3507,1599,1908,2015,6,98
1204,後楽一丁目,449,731,355,376,2015,7,10
1205,後楽二丁目,827,1462,724,738,2015,7,51
1206,春日一丁目,976,1540,709,831,2015,7,62
1207,春日二丁目,2043,4021,1924,2097,2015,7,65
1208,小石川一丁目,1971,3658,1689,1969,2015,7,84
1209,小石川二丁目,2138,3920,1866,2054,2015,7,54
1210,小石川三丁目,2493,5131,2431,2700,2015,7,57
1211,小石川四丁目,1692,3375,1534,1841,2015,7,52
1212,小石川五丁目,2932,5589,2564,3025,2015,7,112
1213,白山一丁目,2608,4651,2282,2369,2015,7,129
1214,白山二丁目,2225,4109,2020,2089,2015,7,110
1215,白山三丁目,532,1024,498,526,2015,7,15
1216,白山四丁目,2247,4326,2057,2269,2015,7,80
1217,白山五丁目,2114,3757,1724,2033,2015,7,87
1218,千石一丁目,1900,3888,1831,2057,2015,7,49
1219,千石二丁目,1985,4077,1961,2116,2015,7,66
1220,千石三丁目,2109,4255,2033,2222,2015,7,42
1221,千石四丁目,3164,5494,2621,2873,2015,7,189
1222,水道一丁目,1379,2556,1256,1300,2015,7,64
1223,水道二丁目,1917,3066,1550,1516,2015,7,125
1224,小日向一丁目,1148,2236,1017,1219,2015,7,19
1225,小日向二丁目,1071,2388,1146,1242,2015,7,29
1226,小日向三丁目,647,1295,618,677,2015,7,13
1227,小日向四丁目,963,1803,853,950,2015,7,46
1228,大塚一丁目,553,1160,535,625,2015,7,5
1229,大塚二丁目,1049,1925,822,1103,2015,7,17
1230,大塚三丁目,2066,3452,1606,1846,2015,7,144
1231,大塚四丁目,1784,3064,1431,1633,2015,7,60
1232,大塚五丁目,2388,4330,2058,2272,2015,7,78
1233,大塚六丁目,2201,3814,1912,1902,2015,7,55
1234,関口一丁目,2604,4412,2069,2343,2015,7,132
1235,関口二丁目,487,1013,474,539,2015,7,7
1236,関口三丁目,446,898,435,463,2015,7,10
1237,目白台一丁目,1262,2222,1196,1026,2015,7,54
1238,目白台二丁目,1166,2123,989,1134,2015,7,17
1239,目白台三丁目,1332,2551,1186,1365,2015,7,56
1240,音羽一丁目,2351,3993,1789,2204,2015,7,100
1241,音羽二丁目,961,1715,751,964,2015,7,63
1242,本郷一丁目,2119,4113,1901,2212,2015,7,88
1243,本郷二丁目,1823,3052,1438,1614,2015,7,84
1244,本郷三丁目,1922,2990,1387,1603,2015,7,85
1245,本郷四丁目,2166,3940,1887,2053,2015,7,72
1246,本郷五丁目,1877,3320,1701,1619,2015,7,61
1247,本郷六丁目,1081,1878,942,936,2015,7,78
1248,湯島一丁目,470,684,319,365,2015,7,30
1249,湯島二丁目,1613,2687,1356,1331,2015,7,84
1250,湯島三丁目,1852,2854,1408,1446,2015,7,182
1251,湯島四丁目,1187,2126,1076,1050,2015,7,46
1252,西片一丁目,1180,2379,1131,1248,2015,7,28
1253,西片二丁目,1454,2904,1445,1459,2015,7,45
1254,向丘一丁目,1789,3266,1624,1642,2015,7,109
1255,向丘二丁目,1855,3217,1507,1710,2015,7,89
1256,弥生一丁目,227,410,203,207,2015,7,11
1257,弥生二丁目,818,1561,756,805,2015,7,34
1258,根津一丁目,1384,2492,1108,1384,2015,7,28
1259,根津二丁目,2219,3800,1824,1976,2015,7,60
1260,千駄木一丁目,714,1490,686,804,2015,7,20
1261,千駄木二丁目,2506,4354,2053,2301,2015,7,128
1262,千駄木三丁目,3800,6762,3223,3539,2015,7,167
1263,千駄木四丁目,1610,3013,1503,1510,2015,7,62
1264,千駄木五丁目,2269,4642,2243,2399,2015,7,78
1265,本駒込一丁目,2323,4530,2135,2395,2015,7,115
1266,本駒込二丁目,2584,4915,2391,2524,2015,7,134
1267,本駒込三丁目,1814,3264,1553,1711,2015,7,79
1268,本駒込四丁目,2123,4155,2005,2150,2015,7,86
1269,本駒込五丁目,3061,5708,2735,2973,2015,7,158
1270,本駒込六丁目,1788,3506,1598,1908,2015,7,80
1271,後楽一丁目,448,734,355,379,2015,8,9
1272,後楽二丁目,836,1475,729,746,2015,8,33
1273,春日一丁目,975,1537,708,829,2015,8,62
1274,春日二丁目,2046,4026,1926,2100,2015,8,65
1275,小石川一丁目,1953,3648,1681,1967,2015,8,65
1276,小石川二丁目,2132,3913,1860,2053,2015,8,42
1277,小石川三丁目,2508,5152,2447,2705,2015,8,62
1278,小石川四丁目,1686,3360,1526,1834,2015,8,62
1279,小石川五丁目,2929,5581,2556,3025,2015,8,95
1280,白山一丁目,2616,4664,2286,2378,2015,8,110
1281,白山二丁目,2224,4115,2017,2098,2015,8,104
1282,白山三丁目,534,1030,502,528,2015,8,13
1283,白山四丁目,2241,4329,2050,2279,2015,8,76
1284,白山五丁目,2133,3778,1732,2046,2015,8,88
1285,千石一丁目,1893,3853,1815,2038,2015,8,43
1286,千石二丁目,1998,4113,1985,2128,2015,8,46
1287,千石三丁目,2106,4256,2036,2220,2015,8,44
1288,千石四丁目,3175,5514,2630,2884,2015,8,176
1289,水道一丁目,1392,2573,1264,1309,2015,8,78
1290,水道二丁目,1913,3063,1544,1519,2015,8,110
1291,小日向一丁目,1140,2227,1012,1215,2015,8,19
1292,小日向二丁目,1073,2386,1146,1240,2015,8,18
1293,小日向三丁目,646,1293,615,678,2015,8,21
1294,小日向四丁目,963,1800,848,952,2015,8,36
1295,大塚一丁目,555,1169,539,630,2015,8,8
1296,大塚二丁目,1051,1927,821,1106,2015,8,24
1297,大塚三丁目,2070,3459,1605,1854,2015,8,155
1298,大塚四丁目,1791,3059,1420,1639,2015,8,63
1299,大塚五丁目,2398,4346,2068,2278,2015,8,88
1300,大塚六丁目,2199,3824,1916,1908,2015,8,57
1301,関口一丁目,2605,4414,2075,2339,2015,8,131
1302,関口二丁目,484,1014,477,537,2015,8,9
1303,関口三丁目,445,899,436,463,2015,8,10
1304,目白台一丁目,1253,2211,1186,1025,2015,8,46
1305,目白台二丁目,1173,2137,1000,1137,2015,8,21
1306,目白台三丁目,1327,2541,1181,1360,2015,8,45
1307,音羽一丁目,2346,3994,1792,2202,2015,8,86
1308,音羽二丁目,965,1723,753,970,2015,8,41
1309,本郷一丁目,2121,4131,1904,2227,2015,8,56
1310,本郷二丁目,1827,3065,1442,1623,2015,8,86
1311,本郷三丁目,1923,2999,1388,1611,2015,8,97
1312,本郷四丁目,2175,3945,1889,2056,2015,8,59
1313,本郷五丁目,1879,3322,1701,1621,2015,8,63
1314,本郷六丁目,1079,1882,943,939,2015,8,81
1315,湯島一丁目,466,680,315,365,2015,8,21
1316,湯島二丁目,1618,2688,1358,1330,2015,8,83
1317,湯島三丁目,1846,2853,1408,1445,2015,8,172
1318,湯島四丁目,1185,2131,1082,1049,2015,8,59
1319,西片一丁目,1186,2392,1137,1255,2015,8,30
1320,西片二丁目,1461,2911,1451,1460,2015,8,44
1321,向丘一丁目,1798,3274,1627,1647,2015,8,105
1322,向丘二丁目,1851,3220,1517,1703,2015,8,77
1323,弥生一丁目,231,417,206,211,2015,8,12
1324,弥生二丁目,821,1565,756,809,2015,8,45
1325,根津一丁目,1385,2497,1113,1384,2015,8,29
1326,根津二丁目,2225,3802,1825,1977,2015,8,55
1327,千駄木一丁目,716,1485,681,804,2015,8,19
1328,千駄木二丁目,2511,4360,2055,2305,2015,8,120
1329,千駄木三丁目,3774,6741,3206,3535,2015,8,172
1330,千駄木四丁目,1609,3020,1504,1516,2015,8,79
1331,千駄木五丁目,2264,4617,2235,2382,2015,8,63
1332,本駒込一丁目,2339,4562,2150,2412,2015,8,99
1333,本駒込二丁目,2582,4925,2402,2523,2015,8,118
1334,本駒込三丁目,1803,3251,1546,1705,2015,8,63
1335,本駒込四丁目,2117,4153,2003,2150,2015,8,73
1336,本駒込五丁目,3066,5721,2748,2973,2015,8,149
1337,本駒込六丁目,1796,3524,1615,1909,2015,8,61
1338,後楽一丁目,443,732,357,375,2015,9,7
1339,後楽二丁目,841,1481,729,752,2015,9,41
1340,春日一丁目,951,1508,679,829,2015,9,46
1341,春日二丁目,2037,4033,1927,2106,2015,9,68
1342,小石川一丁目,1946,3654,1688,1966,2015,9,57
1343,小石川二丁目,2137,3918,1859,2059,2015,9,34
1344,小石川三丁目,2507,5157,2451,2706,2015,9,60
1345,小石川四丁目,1681,3350,1524,1826,2015,9,75
1346,小石川五丁目,2924,5583,2562,3021,2015,9,124
1347,白山一丁目,2616,4668,2277,2391,2015,9,118
1348,白山二丁目,2222,4128,2026,2102,2015,9,121
1349,白山三丁目,530,1027,502,525,2015,9,15
1350,白山四丁目,2238,4324,2055,2269,2015,9,70
1351,白山五丁目,2132,3771,1732,2039,2015,9,90
1352,千石一丁目,1893,3843,1805,2038,2015,9,44
1353,千石二丁目,2004,4131,1994,2137,2015,9,46
1354,千石三丁目,2099,4242,2027,2215,2015,9,55
1355,千石四丁目,3180,5521,2638,2883,2015,9,156
1356,水道一丁目,1394,2587,1276,1311,2015,9,71
1357,水道二丁目,1918,3077,1551,1526,2015,9,121
1358,小日向一丁目,1144,2231,1017,1214,2015,9,14
1359,小日向二丁目,1082,2403,1155,1248,2015,9,20
1360,小日向三丁目,644,1291,615,676,2015,9,20
1361,小日向四丁目,959,1802,856,946,2015,9,40
1362,大塚一丁目,559,1172,540,632,2015,9,4
1363,大塚二丁目,1053,1929,825,1104,2015,9,20
1364,大塚三丁目,2068,3461,1598,1863,2015,9,172
1365,大塚四丁目,1786,3057,1420,1637,2015,9,57
1366,大塚五丁目,2391,4332,2067,2265,2015,9,87
1367,大塚六丁目,2194,3807,1909,1898,2015,9,65
1368,関口一丁目,2614,4440,2085,2355,2015,9,102
1369,関口二丁目,484,1010,476,534,2015,9,7
1370,関口三丁目,446,906,443,463,2015,9,11
1371,目白台一丁目,1243,2198,1175,1023,2015,9,32
1372,目白台二丁目,1162,2122,999,1123,2015,9,23
1373,目白台三丁目,1323,2528,1175,1353,2015,9,37
1374,音羽一丁目,2354,4003,1795,2208,2015,9,92
1375,音羽二丁目,968,1732,761,971,2015,9,33
1376,本郷一丁目,2126,4140,1908,2232,2015,9,85
1377,本郷二丁目,1835,3083,1451,1632,2015,9,80
1378,本郷三丁目,1919,2996,1387,1609,2015,9,98
1379,本郷四丁目,2171,3945,1894,2051,2015,9,76
1380,本郷五丁目,1885,3334,1708,1626,2015,9,62
1381,本郷六丁目,1082,1884,946,938,2015,9,72
1382,湯島一丁目,467,681,317,364,2015,9,26
1383,湯島二丁目,1634,2694,1361,1333,2015,9,86
1384,湯島三丁目,1839,2837,1399,1438,2015,9,151
1385,湯島四丁目,1187,2127,1080,1047,2015,9,41
1386,西片一丁目,1187,2390,1136,1254,2015,9,25
1387,西片二丁目,1459,2904,1447,1457,2015,9,40
1388,向丘一丁目,1792,3268,1625,1643,2015,9,91
1389,向丘二丁目,1862,3238,1521,1717,2015,9,66
1390,弥生一丁目,231,415,206,209,2015,9,12
1391,弥生二丁目,820,1563,756,807,2015,9,49
1392,根津一丁目,1377,2483,1107,1376,2015,9,29
1393,根津二丁目,2217,3782,1815,1967,2015,9,66
1394,千駄木一丁目,710,1476,676,800,2015,9,19
1395,千駄木二丁目,2512,4353,2056,2297,2015,9,114
1396,千駄木三丁目,3724,6679,3178,3501,2015,9,208
1397,千駄木四丁目,1608,3016,1501,1515,2015,9,83
1398,千駄木五丁目,2257,4620,2228,2392,2015,9,74
1399,本駒込一丁目,2342,4571,2154,2417,2015,9,114
1400,本駒込二丁目,2578,4933,2406,2527,2015,9,95
1401,本駒込三丁目,1797,3248,1542,1706,2015,9,68
1402,本駒込四丁目,2119,4159,2003,2156,2015,9,62
1403,本駒込五丁目,3057,5715,2743,2972,2015,9,150
1404,本駒込六丁目,1801,3541,1628,1913,2015,9,69
1405,後楽一丁目,442,733,361,372,2015,10,3
1406,後楽二丁目,845,1489,733,756,2015,10,46
1407,春日一丁目,948,1503,672,831,2015,10,44
1408,春日二丁目,2041,4034,1924,2110,2015,10,75
1409,小石川一丁目,1911,3605,1663,1942,2015,10,40
1410,小石川二丁目,2144,3923,1861,2062,2015,10,54
1411,小石川三丁目,2503,5145,2443,2702,2015,10,55
1412,小石川四丁目,1683,3346,1522,1824,2015,10,76
1413,小石川五丁目,2936,5591,2561,3030,2015,10,139
1414,白山一丁目,2628,4683,2290,2393,2015,10,109
1415,白山二丁目,2227,4128,2027,2101,2015,10,124
1416,白山三丁目,534,1027,501,526,2015,10,15
1417,白山四丁目,2243,4317,2053,2264,2015,10,66
1418,白山五丁目,2131,3757,1724,2033,2015,10,103
1419,千石一丁目,1896,3850,1806,2044,2015,10,57
1420,千石二丁目,2011,4150,2009,2141,2015,10,44
1421,千石三丁目,2106,4266,2043,2223,2015,10,57
1422,千石四丁目,3167,5503,2634,2869,2015,10,153
1423,水道一丁目,1398,2590,1279,1311,2015,10,63
1424,水道二丁目,1915,3058,1542,1516,2015,10,112
1425,小日向一丁目,1148,2246,1024,1222,2015,10,18
1426,小日向二丁目,1084,2417,1163,1254,2015,10,22
1427,小日向三丁目,641,1278,607,671,2015,10,19
1428,小日向四丁目,954,1789,848,941,2015,10,40
1429,大塚一丁目,567,1184,550,634,2015,10,8
1430,大塚二丁目,1056,1925,820,1105,2015,10,25
1431,大塚三丁目,2072,3462,1603,1859,2015,10,180
1432,大塚四丁目,1796,3075,1428,1647,2015,10,55
1433,大塚五丁目,2381,4325,2065,2260,2015,10,82
1434,大塚六丁目,2197,3802,1914,1888,2015,10,74
1435,関口一丁目,2650,4482,2097,2385,2015,10,97
1436,関口二丁目,489,1012,480,532,2015,10,9
1437,関口三丁目,445,914,445,469,2015,10,13
1438,目白台一丁目,1268,2220,1191,1029,2015,10,32
1439,目白台二丁目,1158,2115,996,1119,2015,10,18
1440,目白台三丁目,1325,2530,1175,1355,2015,10,34
1441,音羽一丁目,2345,3997,1789,2208,2015,10,99
1442,音羽二丁目,962,1722,758,964,2015,10,28
1443,本郷一丁目,2116,4118,1899,2219,2015,10,92
1444,本郷二丁目,1836,3073,1451,1622,2015,10,116
1445,本郷三丁目,1927,3005,1389,1616,2015,10,76
1446,本郷四丁目,2227,4068,1951,2117,2015,10,83
1447,本郷五丁目,1894,3352,1716,1636,2015,10,67
1448,本郷六丁目,1093,1895,948,947,2015,10,55
1449,湯島一丁目,468,686,317,369,2015,10,20
1450,湯島二丁目,1636,2689,1360,1329,2015,10,77
1451,湯島三丁目,1838,2840,1400,1440,2015,10,164
1452,湯島四丁目,1197,2141,1082,1059,2015,10,44
1453,西片一丁目,1194,2393,1140,1253,2015,10,33
1454,西片二丁目,1448,2880,1427,1453,2015,10,45
1455,向丘一丁目,1804,3276,1639,1637,2015,10,93
1456,向丘二丁目,1866,3245,1517,1728,2015,10,67
1457,弥生一丁目,231,415,205,210,2015,10,10
1458,弥生二丁目,823,1558,755,803,2015,10,50
1459,根津一丁目,1377,2484,1106,1378,2015,10,24
1460,根津二丁目,2218,3787,1808,1979,2015,10,89
1461,千駄木一丁目,713,1481,678,803,2015,10,15
1462,千駄木二丁目,2515,4354,2051,2303,2015,10,95
1463,千駄木三丁目,3787,6742,3200,3542,2015,10,173
1464,千駄木四丁目,1623,3033,1501,1532,2015,10,69
1465,千駄木五丁目,2257,4623,2231,2392,2015,10,84
1466,本駒込一丁目,2339,4559,2145,2414,2015,10,108
1467,本駒込二丁目,2597,4963,2416,2547,2015,10,131
1468,本駒込三丁目,1789,3234,1536,1698,2015,10,70
1469,本駒込四丁目,2127,4172,2007,2165,2015,10,84
1470,本駒込五丁目,3069,5720,2744,2976,2015,10,157
1471,本駒込六丁目,1802,3547,1628,1919,2015,10,70
1472,後楽一丁目,442,735,366,369,2015,11,4
1473,後楽二丁目,860,1508,748,760,2015,11,47
1474,春日一丁目,952,1512,679,833,2015,11,57
1475,春日二丁目,2044,4041,1936,2105,2015,11,74
1476,小石川一丁目,1897,3588,1652,1936,2015,11,45
1477,小石川二丁目,2143,3923,1868,2055,2015,11,57
1478,小石川三丁目,2495,5141,2448,2693,2015,11,47
1479,小石川四丁目,1678,3347,1522,1825,2015,11,74
1480,小石川五丁目,2915,5571,2549,3022,2015,11,158
1481,白山一丁目,2625,4674,2291,2383,2015,11,112
1482,白山二丁目,2235,4140,2036,2104,2015,11,133
1483,白山三丁目,538,1028,501,527,2015,11,24
1484,白山四丁目,2252,4336,2063,2273,2015,11,57
1485,白山五丁目,2133,3770,1728,2042,2015,11,112
1486,千石一丁目,1887,3835,1797,2038,2015,11,62
1487,千石二丁目,2010,4158,2015,2143,2015,11,52
1488,千石三丁目,2102,4252,2034,2218,2015,11,53
1489,千石四丁目,3195,5530,2650,2880,2015,11,194
1490,水道一丁目,1401,2595,1284,1311,2015,11,46
1491,水道二丁目,1925,3076,1552,1524,2015,11,103
1492,小日向一丁目,1146,2249,1029,1220,2015,11,13
1493,小日向二丁目,1081,2413,1159,1254,2015,11,32
1494,小日向三丁目,642,1281,610,671,2015,11,26
1495,小日向四丁目,947,1769,839,930,2015,11,62
1496,大塚一丁目,536,1149,517,632,2015,11,7
1497,大塚二丁目,1060,1930,822,1108,2015,11,23
1498,大塚三丁目,2087,3483,1613,1870,2015,11,170
1499,大塚四丁目,1805,3084,1432,1652,2015,11,64
1500,大塚五丁目,2392,4336,2063,2273,2015,11,75
1501,大塚六丁目,2212,3826,1924,1902,2015,11,63
1502,関口一丁目,2648,4482,2097,2385,2015,11,93
1503,関口二丁目,486,1009,478,531,2015,11,12
1504,関口三丁目,444,920,449,471,2015,11,10
1505,目白台一丁目,1267,2220,1191,1029,2015,11,28
1506,目白台二丁目,1166,2130,1004,1126,2015,11,23
1507,目白台三丁目,1322,2531,1166,1365,2015,11,38
1508,音羽一丁目,2359,4015,1800,2215,2015,11,99
1509,音羽二丁目,959,1717,756,961,2015,11,37
1510,本郷一丁目,2116,4129,1901,2228,2015,11,72
1511,本郷二丁目,1834,3074,1455,1619,2015,11,91
1512,本郷三丁目,1928,3010,1388,1622,2015,11,72
1513,本郷四丁目,2243,4095,1953,2142,2015,11,71
1514,本郷五丁目,1893,3352,1711,1641,2015,11,55
1515,本郷六丁目,1099,1902,950,952,2015,11,48
1516,湯島一丁目,470,685,316,369,2015,11,15
1517,湯島二丁目,1647,2705,1370,1335,2015,11,75
1518,湯島三丁目,1835,2823,1395,1428,2015,11,181
1519,湯島四丁目,1181,2120,1060,1060,2015,11,41
1520,西片一丁目,1187,2378,1135,1243,2015,11,39
1521,西片二丁目,1448,2869,1418,1451,2015,11,38
1522,向丘一丁目,1811,3300,1656,1644,2015,11,114
1523,向丘二丁目,1863,3243,1522,1721,2015,11,66
1524,弥生一丁目,231,413,202,211,2015,11,5
1525,弥生二丁目,819,1551,751,800,2015,11,47
1526,根津一丁目,1376,2484,1108,1376,2015,11,20
1527,根津二丁目,2220,3787,1807,1980,2015,11,62
1528,千駄木一丁目,714,1487,685,802,2015,11,19
1529,千駄木二丁目,2531,4367,2067,2300,2015,11,96
1530,千駄木三丁目,3795,6742,3202,3540,2015,11,147
1531,千駄木四丁目,1627,3037,1495,1542,2015,11,70
1532,千駄木五丁目,2239,4608,2222,2386,2015,11,91
1533,本駒込一丁目,2345,4573,2156,2417,2015,11,93
1534,本駒込二丁目,2596,4960,2417,2543,2015,11,110
1535,本駒込三丁目,1790,3244,1542,1702,2015,11,60
1536,本駒込四丁目,2125,4173,2008,2165,2015,11,63
1537,本駒込五丁目,3068,5716,2736,2980,2015,11,172
1538,本駒込六丁目,1803,3554,1635,1919,2015,11,75
1539,後楽一丁目,432,719,355,364,2015,12,5
1540,後楽二丁目,855,1503,746,757,2015,12,34
1541,春日一丁目,952,1511,678,833,2015,12,61
1542,春日二丁目,2033,4034,1934,2100,2015,12,77
1543,小石川一丁目,1879,3552,1638,1914,2015,12,38
1544,小石川二丁目,2143,3926,1875,2051,2015,12,67
1545,小石川三丁目,2494,5145,2447,2698,2015,12,66
1546,小石川四丁目,1737,3493,1596,1897,2015,12,71
1547,小石川五丁目,2895,5543,2528,3015,2015,12,136
1548,白山一丁目,2628,4667,2292,2375,2015,12,119
1549,白山二丁目,2238,4154,2044,2110,2015,12,147
1550,白山三丁目,534,1021,500,521,2015,12,24
1551,白山四丁目,2258,4340,2060,2280,2015,12,61
1552,白山五丁目,2127,3756,1720,2036,2015,12,112
1553,千石一丁目,1884,3828,1792,2036,2015,12,78
1554,千石二丁目,2020,4186,2027,2159,2015,12,49
1555,千石三丁目,2121,4289,2054,2235,2015,12,52
1556,千石四丁目,3202,5538,2648,2890,2015,12,213
1557,水道一丁目,1405,2604,1286,1318,2015,12,46
1558,水道二丁目,1951,3106,1565,1541,2015,12,113
1559,小日向一丁目,1150,2255,1031,1224,2015,12,15
1560,小日向二丁目,1082,2413,1159,1254,2015,12,38
1561,小日向三丁目,645,1284,611,673,2015,12,22
1562,小日向四丁目,941,1762,834,928,2015,12,68
1563,大塚一丁目,531,1139,512,627,2015,12,8
1564,大塚二丁目,1055,1924,820,1104,2015,12,18
1565,大塚三丁目,2084,3469,1606,1863,2015,12,159
1566,大塚四丁目,1787,3054,1417,1637,2015,12,74
1567,大塚五丁目,2394,4342,2058,2284,2015,12,92
1568,大塚六丁目,2214,3826,1928,1898,2015,12,54
1569,関口一丁目,2641,4470,2094,2376,2015,12,125
1570,関口二丁目,491,1016,481,535,2015,12,10
1571,関口三丁目,447,923,450,473,2015,12,12
1572,目白台一丁目,1259,2213,1187,1026,2015,12,34
1573,目白台二丁目,1170,2139,1009,1130,2015,12,26
1574,目白台三丁目,1322,2540,1169,1371,2015,12,45
1575,音羽一丁目,2358,4011,1798,2213,2015,12,93
1576,音羽二丁目,966,1730,759,971,2015,12,41
1577,本郷一丁目,2125,4158,1912,2246,2015,12,83
1578,本郷二丁目,1836,3078,1457,1621,2015,12,99
1579,本郷三丁目,1920,3004,1381,1623,2015,12,83
1580,本郷四丁目,2247,4104,1956,2148,2015,12,72
1581,本郷五丁目,1890,3351,1712,1639,2015,12,53
1582,本郷六丁目,1102,1909,957,952,2015,12,43
1583,湯島一丁目,470,690,321,369,2015,12,20
1584,湯島二丁目,1636,2687,1367,1320,2015,12,77
1585,湯島三丁目,1840,2823,1400,1423,2015,12,146
1586,湯島四丁目,1180,2112,1058,1054,2015,12,43
1587,西片一丁目,1184,2380,1138,1242,2015,12,33
1588,西片二丁目,1457,2884,1435,1449,2015,12,38
1589,向丘一丁目,1819,3329,1670,1659,2015,12,98
1590,向丘二丁目,1863,3239,1519,1720,2015,12,65
1591,弥生一丁目,233,416,204,212,2015,12,3
1592,弥生二丁目,816,1548,743,805,2015,12,44
1593,根津一丁目,1377,2485,1105,1380,2015,12,29
1594,根津二丁目,2237,3806,1813,1993,2015,12,50
1595,千駄木一丁目,715,1490,686,804,2015,12,20
1596,千駄木二丁目,2520,4356,2061,2295,2015,12,104
1597,千駄木三丁目,3795,6744,3202,3542,2015,12,145
1598,千駄木四丁目,1625,3026,1486,1540,2015,12,69
1599,千駄木五丁目,2233,4611,2220,2391,2015,12,88
1600,本駒込一丁目,2343,4567,2151,2416,2015,12,91
1601,本駒込二丁目,2601,4972,2420,2552,2015,12,109
1602,本駒込三丁目,1794,3253,1545,1708,2015,12,50
1603,本駒込四丁目,2126,4164,2002,2162,2015,12,69
1604,本駒込五丁目,3079,5734,2744,2990,2015,12,181
1605,本駒込六丁目,1806,3559,1642,1917,2015,12,65
1606,後楽一丁目,519,815,437,378,2014,1,10
1607,後楽二丁目,822,1475,744,731,2014,1,85
1608,春日一丁目,970,1536,710,826,2014,1,63
1609,春日二丁目,1983,3931,1869,2062,2014,1,91
1610,小石川一丁目,1991,3670,1687,1983,2014,1,96
1611,小石川二丁目,2093,3819,1795,2024,2014,1,103
1612,小石川三丁目,2416,4950,2364,2586,2014,1,84
1613,小石川四丁目,1707,3369,1503,1866,2014,1,82
1614,小石川五丁目,2853,5406,2502,2904,2014,1,168
1615,白山一丁目,2527,4549,2238,2311,2014,1,139
1616,白山二丁目,2162,4019,1954,2065,2014,1,104
1617,白山三丁目,531,1040,497,543,2014,1,20
1618,白山四丁目,2245,4330,2064,2266,2014,1,75
1619,白山五丁目,2065,3665,1688,1977,2014,1,135
1620,千石一丁目,1848,3832,1803,2029,2014,1,66
1621,千石二丁目,1915,3898,1850,2048,2014,1,73
1622,千石三丁目,2126,4281,2087,2194,2014,1,75
1623,千石四丁目,3005,5264,2516,2748,2014,1,226
1624,水道一丁目,1368,2535,1227,1308,2014,1,83
1625,水道二丁目,1813,2918,1475,1443,2014,1,149
1626,小日向一丁目,1081,2117,967,1150,2014,1,15
1627,小日向二丁目,1065,2390,1158,1232,2014,1,26
1628,小日向三丁目,657,1305,640,665,2014,1,19
1629,小日向四丁目,924,1733,826,907,2014,1,61
1630,大塚一丁目,548,1186,549,637,2014,1,8
1631,大塚二丁目,990,1835,804,1031,2014,1,32
1632,大塚三丁目,1935,3267,1500,1767,2014,1,160
1633,大塚四丁目,1701,2945,1354,1591,2014,1,64
1634,大塚五丁目,2307,4204,1994,2210,2014,1,130
1635,大塚六丁目,2118,3655,1836,1819,2014,1,98
1636,関口一丁目,2422,4189,1968,2221,2014,1,218
1637,関口二丁目,446,915,428,487,2014,1,24
1638,関口三丁目,438,908,432,476,2014,1,37
1639,目白台一丁目,1306,2247,1244,1003,2014,1,40
1640,目白台二丁目,1130,2049,964,1085,2014,1,26
1641,目白台三丁目,1304,2509,1190,1319,2014,1,49
1642,音羽一丁目,2239,3820,1693,2127,2014,1,157
1643,音羽二丁目,980,1745,746,999,2014,1,38
1644,本郷一丁目,2022,3875,1778,2097,2014,1,113
1645,本郷二丁目,1765,2978,1391,1587,2014,1,137
1646,本郷三丁目,1791,2854,1332,1522,2014,1,80
1647,本郷四丁目,2122,3840,1806,2034,2014,1,70
1648,本郷五丁目,1815,3242,1665,1577,2014,1,82
1649,本郷六丁目,1091,1838,945,893,2014,1,66
1650,湯島一丁目,434,659,289,370,2014,1,39
1651,湯島二丁目,1474,2427,1219,1208,2014,1,134
1652,湯島三丁目,1831,2862,1425,1437,2014,1,170
1653,湯島四丁目,1145,2049,1054,995,2014,1,52
1654,西片一丁目,1164,2389,1130,1259,2014,1,48
1655,西片二丁目,1454,2902,1453,1449,2014,1,54
1656,向丘一丁目,1793,3279,1649,1630,2014,1,103
1657,向丘二丁目,1878,3275,1545,1730,2014,1,71
1658,弥生一丁目,254,443,222,221,2014,1,10
1659,弥生二丁目,830,1560,756,804,2014,1,42
1660,根津一丁目,1351,2445,1094,1351,2014,1,30
1661,根津二丁目,2126,3718,1764,1954,2014,1,82
1662,千駄木一丁目,709,1456,676,780,2014,1,17
1663,千駄木二丁目,2436,4331,2027,2304,2014,1,127
1664,千駄木三丁目,3589,6464,3074,3390,2014,1,238
1665,千駄木四丁目,1588,2938,1447,1491,2014,1,80
1666,千駄木五丁目,2253,4576,2199,2377,2014,1,95
1667,本駒込一丁目,2266,4391,2066,2325,2014,1,98
1668,本駒込二丁目,2486,4741,2282,2459,2014,1,98
1669,本駒込三丁目,1805,3190,1508,1682,2014,1,71
1670,本駒込四丁目,2099,4118,1995,2123,2014,1,89
1671,本駒込五丁目,2928,5448,2631,2817,2014,1,189
1672,本駒込六丁目,1617,3215,1449,1766,2014,1,94
1673,後楽一丁目,512,805,429,376,2014,2,12
1674,後楽二丁目,829,1483,750,733,2014,2,70
1675,春日一丁目,967,1533,707,826,2014,2,55
1676,春日二丁目,1995,3950,1875,2075,2014,2,106
1677,小石川一丁目,1986,3663,1685,1978,2014,2,107
1678,小石川二丁目,2100,3835,1807,2028,2014,2,111
1679,小石川三丁目,2420,4959,2364,2595,2014,2,99
1680,小石川四丁目,1714,3388,1512,1876,2014,2,81
1681,小石川五丁目,2854,5412,2500,2912,2014,2,158
1682,白山一丁目,2526,4559,2244,2315,2014,2,160
1683,白山二丁目,2164,4027,1959,2068,2014,2,114
1684,白山三丁目,528,1035,493,542,2014,2,18
1685,白山四丁目,2243,4340,2070,2270,2014,2,63
1686,白山五丁目,2060,3657,1687,1970,2014,2,139
1687,千石一丁目,1857,3855,1812,2043,2014,2,67
1688,千石二丁目,1906,3896,1845,2051,2014,2,88
1689,千石三丁目,2122,4287,2085,2202,2014,2,83
1690,千石四丁目,3001,5255,2507,2748,2014,2,190
1691,水道一丁目,1362,2527,1224,1303,2014,2,74
1692,水道二丁目,1818,2927,1475,1452,2014,2,164
1693,小日向一丁目,1080,2114,965,1149,2014,2,16
1694,小日向二丁目,1062,2390,1156,1234,2014,2,28
1695,小日向三丁目,651,1295,632,663,2014,2,20
1696,小日向四丁目,935,1738,826,912,2014,2,54
1697,大塚一丁目,547,1181,548,633,2014,2,6
1698,大塚二丁目,992,1842,807,1035,2014,2,61
1699,大塚三丁目,1933,3263,1500,1763,2014,2,172
1700,大塚四丁目,1709,2957,1358,1599,2014,2,66
1701,大塚五丁目,2304,4206,1997,2209,2014,2,104
1702,大塚六丁目,2111,3650,1834,1816,2014,2,110
1703,関口一丁目,2427,4190,1967,2223,2014,2,185
1704,関口二丁目,448,914,426,488,2014,2,26
1705,関口三丁目,435,900,425,475,2014,2,29
1706,目白台一丁目,1308,2251,1245,1006,2014,2,36
1707,目白台二丁目,1132,2052,964,1088,2014,2,28
1708,目白台三丁目,1303,2503,1186,1317,2014,2,48
1709,音羽一丁目,2252,3836,1699,2137,2014,2,125
1710,音羽二丁目,987,1755,750,1005,2014,2,45
1711,本郷一丁目,2028,3880,1770,2110,2014,2,102
1712,本郷二丁目,1744,2951,1375,1576,2014,2,142
1713,本郷三丁目,1799,2853,1334,1519,2014,2,78
1714,本郷四丁目,2134,3853,1814,2039,2014,2,59
1715,本郷五丁目,1805,3227,1653,1574,2014,2,114
1716,本郷六丁目,1086,1826,937,889,2014,2,65
1717,湯島一丁目,435,663,293,370,2014,2,38
1718,湯島二丁目,1480,2438,1225,1213,2014,2,93
1719,湯島三丁目,1838,2861,1431,1430,2014,2,174
1720,湯島四丁目,1148,2052,1059,993,2014,2,45
1721,西片一丁目,1171,2394,1135,1259,2014,2,32
1722,西片二丁目,1453,2899,1447,1452,2014,2,41
1723,向丘一丁目,1797,3271,1646,1625,2014,2,106
1724,向丘二丁目,1869,3267,1541,1726,2014,2,80
1725,弥生一丁目,253,442,223,219,2014,2,8
1726,弥生二丁目,832,1565,757,808,2014,2,36
1727,根津一丁目,1351,2450,1099,1351,2014,2,26
1728,根津二丁目,2125,3714,1768,1946,2014,2,86
1729,千駄木一丁目,709,1459,677,782,2014,2,17
1730,千駄木二丁目,2443,4339,2026,2313,2014,2,120
1731,千駄木三丁目,3583,6466,3084,3382,2014,2,255
1732,千駄木四丁目,1587,2944,1446,1498,2014,2,69
1733,千駄木五丁目,2258,4587,2203,2384,2014,2,93
1734,本駒込一丁目,2269,4388,2061,2327,2014,2,112
1735,本駒込二丁目,2490,4756,2288,2468,2014,2,107
1736,本駒込三丁目,1808,3202,1515,1687,2014,2,69
1737,本駒込四丁目,2099,4115,1992,2123,2014,2,105
1738,本駒込五丁目,2938,5469,2637,2832,2014,2,170
1739,本駒込六丁目,1607,3204,1447,1757,2014,2,91
1740,後楽一丁目,523,815,439,376,2014,3,15
1741,後楽二丁目,825,1477,746,731,2014,3,82
1742,春日一丁目,971,1536,706,830,2014,3,69
1743,春日二丁目,2006,3972,1891,2081,2014,3,96
1744,小石川一丁目,1993,3672,1687,1985,2014,3,97
1745,小石川二丁目,2090,3818,1801,2017,2014,3,135
1746,小石川三丁目,2419,4949,2354,2595,2014,3,78
1747,小石川四丁目,1715,3379,1511,1868,2014,3,90
1748,小石川五丁目,2853,5415,2501,2914,2014,3,172
1749,白山一丁目,2523,4557,2243,2314,2014,3,138
1750,白山二丁目,2163,4024,1960,2064,2014,3,113
1751,白山三丁目,524,1025,489,536,2014,3,17
1752,白山四丁目,2235,4328,2066,2262,2014,3,84
1753,白山五丁目,2058,3658,1690,1968,2014,3,148
1754,千石一丁目,1856,3853,1805,2048,2014,3,52
1755,千石二丁目,1922,3925,1863,2062,2014,3,82
1756,千石三丁目,2116,4270,2080,2190,2014,3,65
1757,千石四丁目,3010,5262,2512,2750,2014,3,142
1758,水道一丁目,1364,2535,1230,1305,2014,3,64
1759,水道二丁目,1826,2935,1485,1450,2014,3,180
1760,小日向一丁目,1078,2114,963,1151,2014,3,15
1761,小日向二丁目,1063,2387,1154,1233,2014,3,26
1762,小日向三丁目,651,1298,634,664,2014,3,33
1763,小日向四丁目,940,1748,831,917,2014,3,67
1764,大塚一丁目,546,1181,548,633,2014,3,6
1765,大塚二丁目,1002,1860,811,1049,2014,3,24
1766,大塚三丁目,1919,3246,1489,1757,2014,3,189
1767,大塚四丁目,1722,2975,1369,1606,2014,3,50
1768,大塚五丁目,2326,4254,2010,2244,2014,3,114
1769,大塚六丁目,2100,3636,1826,1810,2014,3,110
1770,関口一丁目,2440,4215,1986,2229,2014,3,180
1771,関口二丁目,444,911,426,485,2014,3,20
1772,関口三丁目,437,904,429,475,2014,3,24
1773,目白台一丁目,1296,2238,1231,1007,2014,3,42
1774,目白台二丁目,1126,2042,961,1081,2014,3,33
1775,目白台三丁目,1295,2493,1178,1315,2014,3,46
1776,音羽一丁目,2276,3862,1710,2152,2014,3,125
1777,音羽二丁目,975,1741,744,997,2014,3,55
1778,本郷一丁目,2015,3861,1762,2099,2014,3,91
1779,本郷二丁目,1740,2944,1374,1570,2014,3,141
1780,本郷三丁目,1806,2871,1344,1527,2014,3,98
1781,本郷四丁目,2127,3848,1813,2035,2014,3,64
1782,本郷五丁目,1797,3221,1651,1570,2014,3,107
1783,本郷六丁目,1085,1837,936,901,2014,3,83
1784,湯島一丁目,439,666,298,368,2014,3,34
1785,湯島二丁目,1489,2455,1235,1220,2014,3,104
1786,湯島三丁目,1837,2857,1431,1426,2014,3,191
1787,湯島四丁目,1153,2055,1060,995,2014,3,49
1788,西片一丁目,1173,2392,1130,1262,2014,3,45
1789,西片二丁目,1457,2896,1447,1449,2014,3,41
1790,向丘一丁目,1789,3259,1637,1622,2014,3,106
1791,向丘二丁目,1861,3251,1530,1721,2014,3,109
1792,弥生一丁目,252,437,220,217,2014,3,11
1793,弥生二丁目,826,1556,748,808,2014,3,41
1794,根津一丁目,1366,2466,1107,1359,2014,3,53
1795,根津二丁目,2126,3718,1765,1953,2014,3,89
1796,千駄木一丁目,705,1457,678,779,2014,3,18
1797,千駄木二丁目,2439,4333,2025,2308,2014,3,128
1798,千駄木三丁目,3593,6494,3102,3392,2014,3,207
1799,千駄木四丁目,1581,2946,1443,1503,2014,3,67
1800,千駄木五丁目,2257,4602,2212,2390,2014,3,88
1801,本駒込一丁目,2269,4390,2070,2320,2014,3,143
1802,本駒込二丁目,2495,4763,2293,2470,2014,3,117
1803,本駒込三丁目,1795,3200,1513,1687,2014,3,82
1804,本駒込四丁目,2102,4119,1995,2124,2014,3,115
1805,本駒込五丁目,2940,5469,2638,2831,2014,3,152
1806,本駒込六丁目,1609,3196,1446,1750,2014,3,90
1807,後楽一丁目,518,807,430,377,2014,4,20
1808,後楽二丁目,813,1450,732,718,2014,4,68
1809,春日一丁目,979,1549,714,835,2014,4,55
1810,春日二丁目,2032,3998,1911,2087,2014,4,91
1811,小石川一丁目,1989,3680,1692,1988,2014,4,79
1812,小石川二丁目,2089,3822,1802,2020,2014,4,107
1813,小石川三丁目,2410,4934,2340,2594,2014,4,71
1814,小石川四丁目,1705,3365,1511,1854,2014,4,71
1815,小石川五丁目,2855,5411,2484,2927,2014,4,132
1816,白山一丁目,2520,4547,2237,2310,2014,4,129
1817,白山二丁目,2144,3990,1944,2046,2014,4,119
1818,白山三丁目,526,1018,484,534,2014,4,18
1819,白山四丁目,2239,4329,2056,2273,2014,4,77
1820,白山五丁目,2064,3662,1686,1976,2014,4,131
1821,千石一丁目,1861,3860,1811,2049,2014,4,45
1822,千石二丁目,1913,3903,1859,2044,2014,4,80
1823,千石三丁目,2136,4292,2068,2224,2014,4,70
1824,千石四丁目,3037,5279,2517,2762,2014,4,140
1825,水道一丁目,1373,2548,1238,1310,2014,4,51
1826,水道二丁目,1850,2961,1500,1461,2014,4,139
1827,小日向一丁目,1078,2111,959,1152,2014,4,11
1828,小日向二丁目,1070,2392,1151,1241,2014,4,31
1829,小日向三丁目,642,1293,630,663,2014,4,29
1830,小日向四丁目,949,1763,837,926,2014,4,46
1831,大塚一丁目,538,1165,542,623,2014,4,6
1832,大塚二丁目,1034,1915,828,1087,2014,4,21
1833,大塚三丁目,1945,3298,1517,1781,2014,4,158
1834,大塚四丁目,1759,3000,1393,1607,2014,4,51
1835,大塚五丁目,2328,4269,2014,2255,2014,4,95
1836,大塚六丁目,2117,3656,1838,1818,2014,4,117
1837,関口一丁目,2449,4220,1989,2231,2014,4,165
1838,関口二丁目,451,924,431,493,2014,4,15
1839,関口三丁目,443,907,434,473,2014,4,18
1840,目白台一丁目,1271,2216,1213,1003,2014,4,41
1841,目白台二丁目,1134,2062,968,1094,2014,4,34
1842,目白台三丁目,1284,2495,1180,1315,2014,4,36
1843,音羽一丁目,2299,3879,1719,2160,2014,4,107
1844,音羽二丁目,978,1735,747,988,2014,4,54
1845,本郷一丁目,2049,3932,1803,2129,2014,4,107
1846,本郷二丁目,1739,2940,1378,1562,2014,4,121
1847,本郷三丁目,1819,2893,1354,1539,2014,4,98
1848,本郷四丁目,2151,3901,1830,2071,2014,4,74
1849,本郷五丁目,1824,3255,1670,1585,2014,4,87
1850,本郷六丁目,1093,1873,945,928,2014,4,66
1851,湯島一丁目,455,680,303,377,2014,4,43
1852,湯島二丁目,1501,2457,1238,1219,2014,4,75
1853,湯島三丁目,1819,2830,1407,1423,2014,4,183
1854,湯島四丁目,1153,2051,1058,993,2014,4,44
1855,西片一丁目,1165,2374,1119,1255,2014,4,45
1856,西片二丁目,1458,2904,1451,1453,2014,4,42
1857,向丘一丁目,1784,3261,1636,1625,2014,4,100
1858,向丘二丁目,1898,3269,1520,1749,2014,4,104
1859,弥生一丁目,249,436,221,215,2014,4,11
1860,弥生二丁目,821,1561,745,816,2014,4,29
1861,根津一丁目,1369,2455,1096,1359,2014,4,44
1862,根津二丁目,2140,3718,1762,1956,2014,4,92
1863,千駄木一丁目,704,1452,677,775,2014,4,17
1864,千駄木二丁目,2439,4315,2020,2295,2014,4,134
1865,千駄木三丁目,3617,6516,3095,3421,2014,4,186
1866,千駄木四丁目,1591,2961,1461,1500,2014,4,73
1867,千駄木五丁目,2255,4598,2211,2387,2014,4,83
1868,本駒込一丁目,2295,4437,2092,2345,2014,4,130
1869,本駒込二丁目,2478,4745,2283,2462,2014,4,109
1870,本駒込三丁目,1795,3195,1502,1693,2014,4,62
1871,本駒込四丁目,2103,4123,1995,2128,2014,4,98
1872,本駒込五丁目,2949,5494,2657,2837,2014,4,149
1873,本駒込六丁目,1647,3229,1455,1774,2014,4,83
1874,後楽一丁目,544,830,446,384,2014,5,15
1875,後楽二丁目,831,1473,743,730,2014,5,74
1876,春日一丁目,972,1541,708,833,2014,5,67
1877,春日二丁目,2023,3984,1902,2082,2014,5,98
1878,小石川一丁目,1984,3670,1691,1979,2014,5,80
1879,小石川二丁目,2079,3805,1786,2019,2014,5,110
1880,小石川三丁目,2409,4934,2344,2590,2014,5,94
1881,小石川四丁目,1712,3370,1522,1848,2014,5,75
1882,小石川五丁目,2866,5415,2489,2926,2014,5,128
1883,白山一丁目,2523,4543,2236,2307,2014,5,138
1884,白山二丁目,2157,4005,1957,2048,2014,5,101
1885,白山三丁目,525,1019,487,532,2014,5,24
1886,白山四丁目,2237,4312,2039,2273,2014,5,81
1887,白山五丁目,2051,3650,1682,1968,2014,5,143
1888,千石一丁目,1873,3859,1810,2049,2014,5,61
1889,千石二丁目,1919,3906,1860,2046,2014,5,81
1890,千石三丁目,2138,4304,2073,2231,2014,5,78
1891,千石四丁目,3063,5308,2530,2778,2014,5,160
1892,水道一丁目,1383,2556,1246,1310,2014,5,68
1893,水道二丁目,1853,2969,1502,1467,2014,5,144
1894,小日向一丁目,1087,2122,964,1158,2014,5,17
1895,小日向二丁目,1071,2386,1149,1237,2014,5,34
1896,小日向三丁目,640,1289,627,662,2014,5,37
1897,小日向四丁目,956,1775,840,935,2014,5,50
1898,大塚一丁目,552,1178,545,633,2014,5,3
1899,大塚二丁目,1060,1943,833,1110,2014,5,17
1900,大塚三丁目,1979,3346,1548,1798,2014,5,161
1901,大塚四丁目,1762,3005,1402,1603,2014,5,52
1902,大塚五丁目,2337,4264,2017,2247,2014,5,116
1903,大塚六丁目,2138,3696,1863,1833,2014,5,112
1904,関口一丁目,2465,4227,1985,2242,2014,5,178
1905,関口二丁目,453,935,433,502,2014,5,18
1906,関口三丁目,447,904,433,471,2014,5,11
1907,目白台一丁目,1295,2236,1236,1000,2014,5,31
1908,目白台二丁目,1154,2118,994,1124,2014,5,36
1909,目白台三丁目,1318,2541,1203,1338,2014,5,40
1910,音羽一丁目,2332,3919,1737,2182,2014,5,132
1911,音羽二丁目,978,1747,755,992,2014,5,58
1912,本郷一丁目,2106,4061,1864,2197,2014,5,114
1913,本郷二丁目,1744,2931,1387,1544,2014,5,122
1914,本郷三丁目,1823,2895,1354,1541,2014,5,103
1915,本郷四丁目,2171,3940,1854,2086,2014,5,77
1916,本郷五丁目,1842,3287,1689,1598,2014,5,75
1917,本郷六丁目,1103,1880,948,932,2014,5,56
1918,湯島一丁目,461,690,310,380,2014,5,47
1919,湯島二丁目,1509,2476,1251,1225,2014,5,93
1920,湯島三丁目,1786,2786,1380,1406,2014,5,204
1921,湯島四丁目,1157,2043,1050,993,2014,5,46
1922,西片一丁目,1166,2381,1124,1257,2014,5,47
1923,西片二丁目,1452,2894,1448,1446,2014,5,56
1924,向丘一丁目,1806,3286,1653,1633,2014,5,110
1925,向丘二丁目,1899,3256,1511,1745,2014,5,120
1926,弥生一丁目,252,439,221,218,2014,5,14
1927,弥生二丁目,826,1568,755,813,2014,5,41
1928,根津一丁目,1376,2465,1095,1370,2014,5,38
1929,根津二丁目,2117,3670,1738,1932,2014,5,102
1930,千駄木一丁目,705,1452,675,777,2014,5,27
1931,千駄木二丁目,2460,4330,2025,2305,2014,5,129
1932,千駄木三丁目,3658,6579,3132,3447,2014,5,186
1933,千駄木四丁目,1591,2939,1449,1490,2014,5,80
1934,千駄木五丁目,2270,4608,2215,2393,2014,5,88
1935,本駒込一丁目,2304,4465,2107,2358,2014,5,130
1936,本駒込二丁目,2519,4776,2295,2481,2014,5,108
1937,本駒込三丁目,1794,3194,1504,1690,2014,5,72
1938,本駒込四丁目,2115,4133,2004,2129,2014,5,74
1939,本駒込五丁目,2961,5510,2660,2850,2014,5,146
1940,本駒込六丁目,1649,3228,1455,1773,2014,5,84
1941,後楽一丁目,564,853,471,382,2014,6,15
1942,後楽二丁目,831,1475,741,734,2014,6,54
1943,春日一丁目,964,1534,704,830,2014,6,68
1944,春日二丁目,2021,3984,1898,2086,2014,6,93
1945,小石川一丁目,1986,3678,1691,1987,2014,6,107
1946,小石川二丁目,2084,3818,1793,2025,2014,6,107
1947,小石川三丁目,2409,4934,2342,2592,2014,6,85
1948,小石川四丁目,1709,3363,1512,1851,2014,6,79
1949,小石川五丁目,2865,5430,2490,2940,2014,6,158
1950,白山一丁目,2521,4547,2237,2310,2014,6,128
1951,白山二丁目,2165,4010,1964,2046,2014,6,151
1952,白山三丁目,528,1023,492,531,2014,6,21
1953,白山四丁目,2237,4316,2048,2268,2014,6,72
1954,白山五丁目,2046,3639,1667,1972,2014,6,155
1955,千石一丁目,1878,3866,1814,2052,2014,6,53
1956,千石二丁目,1924,3913,1861,2052,2014,6,78
1957,千石三丁目,2136,4306,2082,2224,2014,6,75
1958,千石四丁目,3059,5317,2536,2781,2014,6,162
1959,水道一丁目,1383,2554,1245,1309,2014,6,58
1960,水道二丁目,1870,2993,1510,1483,2014,6,142
1961,小日向一丁目,1094,2131,966,1165,2014,6,18
1962,小日向二丁目,1071,2396,1154,1242,2014,6,28
1963,小日向三丁目,641,1297,630,667,2014,6,44
1964,小日向四丁目,959,1781,846,935,2014,6,51
1965,大塚一丁目,560,1181,554,627,2014,6,3
1966,大塚二丁目,1058,1941,832,1109,2014,6,16
1967,大塚三丁目,1985,3359,1547,1812,2014,6,165
1968,大塚四丁目,1781,3029,1416,1613,2014,6,49
1969,大塚五丁目,2333,4261,2018,2243,2014,6,117
1970,大塚六丁目,2141,3706,1866,1840,2014,6,134
1971,関口一丁目,2463,4228,1978,2250,2014,6,184
1972,関口二丁目,454,935,432,503,2014,6,23
1973,関口三丁目,448,906,432,474,2014,6,14
1974,目白台一丁目,1298,2236,1240,996,2014,6,37
1975,目白台二丁目,1159,2125,998,1127,2014,6,43
1976,目白台三丁目,1315,2540,1204,1336,2014,6,30
1977,音羽一丁目,2331,3914,1738,2176,2014,6,94
1978,音羽二丁目,982,1750,755,995,2014,6,57
1979,本郷一丁目,2114,4088,1875,2213,2014,6,117
1980,本郷二丁目,1742,2937,1391,1546,2014,6,117
1981,本郷三丁目,1833,2898,1361,1537,2014,6,92
1982,本郷四丁目,2184,3950,1863,2087,2014,6,87
1983,本郷五丁目,1842,3286,1689,1597,2014,6,81
1984,本郷六丁目,1100,1880,948,932,2014,6,48
1985,湯島一丁目,455,683,305,378,2014,6,35
1986,湯島二丁目,1523,2489,1260,1229,2014,6,100
1987,湯島三丁目,1789,2781,1376,1405,2014,6,198
1988,湯島四丁目,1150,2033,1044,989,2014,6,52
1989,西片一丁目,1164,2379,1127,1252,2014,6,49
1990,西片二丁目,1441,2887,1443,1444,2014,6,58
1991,向丘一丁目,1800,3287,1657,1630,2014,6,95
1992,向丘二丁目,1889,3241,1508,1733,2014,6,119
1993,弥生一丁目,249,433,218,215,2014,6,9
1994,弥生二丁目,823,1562,750,812,2014,6,34
1995,根津一丁目,1392,2486,1106,1380,2014,6,49
1996,根津二丁目,2124,3681,1743,1938,2014,6,108
1997,千駄木一丁目,710,1461,681,780,2014,6,24
1998,千駄木二丁目,2459,4322,2021,2301,2014,6,114
1999,千駄木三丁目,3652,6584,3134,3450,2014,6,175
2000,千駄木四丁目,1588,2943,1449,1494,2014,6,94
2001,千駄木五丁目,2270,4612,2214,2398,2014,6,80
2002,本駒込一丁目,2303,4477,2115,2362,2014,6,123
2003,本駒込二丁目,2536,4809,2312,2497,2014,6,118
2004,本駒込三丁目,1804,3213,1517,1696,2014,6,80
2005,本駒込四丁目,2120,4137,2005,2132,2014,6,87
2006,本駒込五丁目,2964,5529,2673,2856,2014,6,129
2007,本駒込六丁目,1654,3230,1459,1771,2014,6,102
2008,後楽一丁目,567,858,473,385,2014,7,10
2009,後楽二丁目,833,1483,744,739,2014,7,45
2010,春日一丁目,963,1536,707,829,2014,7,64
2011,春日二丁目,2029,3996,1901,2095,2014,7,111
2012,小石川一丁目,1992,3688,1700,1988,2014,7,103
2013,小石川二丁目,2084,3822,1793,2029,2014,7,101
2014,小石川三丁目,2418,4951,2349,2602,2014,7,78
2015,小石川四丁目,1710,3361,1507,1854,2014,7,66
2016,小石川五丁目,2867,5457,2508,2949,2014,7,173
2017,白山一丁目,2529,4572,2245,2327,2014,7,143
2018,白山二丁目,2171,4027,1968,2059,2014,7,180
2019,白山三丁目,525,1014,489,525,2014,7,26
2020,白山四丁目,2235,4334,2058,2276,2014,7,78
2021,白山五丁目,2051,3644,1671,1973,2014,7,153
2022,千石一丁目,1884,3867,1815,2052,2014,7,57
2023,千石二丁目,1927,3922,1861,2061,2014,7,75
2024,千石三丁目,2143,4325,2092,2233,2014,7,68
2025,千石四丁目,3057,5316,2532,2784,2014,7,184
2026,水道一丁目,1373,2540,1241,1299,2014,7,71
2027,水道二丁目,1880,3006,1520,1486,2014,7,126
2028,小日向一丁目,1085,2117,955,1162,2014,7,17
2029,小日向二丁目,1069,2385,1149,1236,2014,7,24
2030,小日向三丁目,641,1302,634,668,2014,7,40
2031,小日向四丁目,965,1795,852,943,2014,7,59
2032,大塚一丁目,560,1183,555,628,2014,7,3
2033,大塚二丁目,1057,1941,831,1110,2014,7,10
2034,大塚三丁目,1996,3373,1557,1816,2014,7,145
2035,大塚四丁目,1788,3038,1422,1616,2014,7,67
2036,大塚五丁目,2325,4245,2009,2236,2014,7,113
2037,大塚六丁目,2141,3714,1872,1842,2014,7,114
2038,関口一丁目,2465,4222,1978,2244,2014,7,144
2039,関口二丁目,453,935,431,504,2014,7,23
2040,関口三丁目,447,901,432,469,2014,7,20
2041,目白台一丁目,1303,2240,1247,993,2014,7,53
2042,目白台二丁目,1153,2125,996,1129,2014,7,52
2043,目白台三丁目,1318,2539,1202,1337,2014,7,30
2044,音羽一丁目,2344,3932,1751,2181,2014,7,93
2045,音羽二丁目,979,1747,755,992,2014,7,35
2046,本郷一丁目,2115,4086,1875,2211,2014,7,123
2047,本郷二丁目,1733,2922,1384,1538,2014,7,105
2048,本郷三丁目,1842,2908,1362,1546,2014,7,118
2049,本郷四丁目,2179,3942,1856,2086,2014,7,74
2050,本郷五丁目,1833,3274,1681,1593,2014,7,82
2051,本郷六丁目,1099,1889,952,937,2014,7,54
2052,湯島一丁目,459,690,309,381,2014,7,36
2053,湯島二丁目,1532,2506,1267,1239,2014,7,94
2054,湯島三丁目,1781,2761,1371,1390,2014,7,194
2055,湯島四丁目,1125,2011,1019,992,2014,7,49
2056,西片一丁目,1166,2384,1126,1258,2014,7,89
2057,西片二丁目,1436,2876,1436,1440,2014,7,54
2058,向丘一丁目,1788,3273,1657,1616,2014,7,103
2059,向丘二丁目,1889,3243,1509,1734,2014,7,92
2060,弥生一丁目,247,433,219,214,2014,7,6
2061,弥生二丁目,821,1558,746,812,2014,7,36
2062,根津一丁目,1391,2477,1098,1379,2014,7,40
2063,根津二丁目,2131,3688,1745,1943,2014,7,72
2064,千駄木一丁目,706,1456,679,777,2014,7,23
2065,千駄木二丁目,2465,4333,2023,2310,2014,7,122
2066,千駄木三丁目,3651,6579,3131,3448,2014,7,192
2067,千駄木四丁目,1586,2942,1454,1488,2014,7,83
2068,千駄木五丁目,2271,4604,2215,2389,2014,7,99
2069,本駒込一丁目,2322,4505,2123,2382,2014,7,87
2070,本駒込二丁目,2538,4822,2321,2501,2014,7,125
2071,本駒込三丁目,1798,3210,1515,1695,2014,7,87
2072,本駒込四丁目,2112,4118,1992,2126,2014,7,100
2073,本駒込五丁目,2952,5512,2661,2851,2014,7,144
2074,本駒込六丁目,1666,3256,1474,1782,2014,7,85
2075,後楽一丁目,572,866,479,387,2014,8,6
2076,後楽二丁目,828,1479,739,740,2014,8,44
2077,春日一丁目,972,1548,710,838,2014,8,48
2078,春日二丁目,2024,3973,1894,2079,2014,8,118
2079,小石川一丁目,1985,3685,1697,1988,2014,8,87
2080,小石川二丁目,2079,3827,1800,2027,2014,8,82
2081,小石川三丁目,2414,4945,2340,2605,2014,8,59
2082,小石川四丁目,1701,3356,1503,1853,2014,8,54
2083,小石川五丁目,2870,5483,2515,2968,2014,8,170
2084,白山一丁目,2537,4572,2243,2329,2014,8,125
2085,白山二丁目,2170,4037,1977,2060,2014,8,192
2086,白山三丁目,521,1010,487,523,2014,8,19
2087,白山四丁目,2238,4342,2068,2274,2014,8,72
2088,白山五丁目,2047,3650,1677,1973,2014,8,151
2089,千石一丁目,1879,3855,1811,2044,2014,8,69
2090,千石二丁目,1921,3914,1854,2060,2014,8,71
2091,千石三丁目,2154,4341,2094,2247,2014,8,68
2092,千石四丁目,3056,5322,2537,2785,2014,8,169
2093,水道一丁目,1372,2542,1239,1303,2014,8,70
2094,水道二丁目,1893,3016,1525,1491,2014,8,117
2095,小日向一丁目,1087,2121,958,1163,2014,8,16
2096,小日向二丁目,1062,2372,1141,1231,2014,8,24
2097,小日向三丁目,643,1302,632,670,2014,8,41
2098,小日向四丁目,962,1793,852,941,2014,8,59
2099,大塚一丁目,555,1177,548,629,2014,8,5
2100,大塚二丁目,1057,1943,830,1113,2014,8,11
2101,大塚三丁目,1992,3369,1558,1811,2014,8,157
2102,大塚四丁目,1788,3038,1422,1616,2014,8,78
2103,大塚五丁目,2334,4267,2014,2253,2014,8,107
2104,大塚六丁目,2140,3720,1870,1850,2014,8,107
2105,関口一丁目,2480,4228,1982,2246,2014,8,139
2106,関口二丁目,449,928,428,500,2014,8,24
2107,関口三丁目,444,896,430,466,2014,8,21
2108,目白台一丁目,1280,2218,1226,992,2014,8,43
2109,目白台二丁目,1143,2115,987,1128,2014,8,48
2110,目白台三丁目,1319,2551,1204,1347,2014,8,46
2111,音羽一丁目,2338,3933,1756,2177,2014,8,94
2112,音羽二丁目,979,1753,760,993,2014,8,25
2113,本郷一丁目,2112,4092,1879,2213,2014,8,133
2114,本郷二丁目,1730,2913,1384,1529,2014,8,98
2115,本郷三丁目,1854,2920,1365,1555,2014,8,125
2116,本郷四丁目,2189,3975,1873,2102,2014,8,70
2117,本郷五丁目,1840,3286,1688,1598,2014,8,86
2118,本郷六丁目,1091,1883,954,929,2014,8,55
2119,湯島一丁目,471,700,322,378,2014,8,33
2120,湯島二丁目,1537,2504,1265,1239,2014,8,88
2121,湯島三丁目,1791,2769,1380,1389,2014,8,188
2122,湯島四丁目,1126,2007,1022,985,2014,8,48
2123,西片一丁目,1164,2375,1119,1256,2014,8,75
2124,西片二丁目,1437,2873,1430,1443,2014,8,44
2125,向丘一丁目,1794,3280,1657,1623,2014,8,95
2126,向丘二丁目,1882,3243,1513,1730,2014,8,84
2127,弥生一丁目,242,428,215,213,2014,8,6
2128,弥生二丁目,815,1552,741,811,2014,8,36
2129,根津一丁目,1384,2466,1091,1375,2014,8,48
2130,根津二丁目,2142,3703,1759,1944,2014,8,85
2131,千駄木一丁目,704,1458,682,776,2014,8,27
2132,千駄木二丁目,2454,4323,2015,2308,2014,8,112
2133,千駄木三丁目,3650,6577,3141,3436,2014,8,187
2134,千駄木四丁目,1582,2938,1459,1479,2014,8,88
2135,千駄木五丁目,2260,4594,2210,2384,2014,8,98
2136,本駒込一丁目,2324,4520,2131,2389,2014,8,77
2137,本駒込二丁目,2534,4812,2307,2505,2014,8,116
2138,本駒込三丁目,1789,3211,1515,1696,2014,8,98
2139,本駒込四丁目,2113,4129,2000,2129,2014,8,92
2140,本駒込五丁目,2965,5531,2671,2860,2014,8,135
2141,本駒込六丁目,1691,3307,1507,1800,2014,8,84
2142,後楽一丁目,562,858,475,383,2014,9,3
2143,後楽二丁目,829,1477,743,734,2014,9,39
2144,春日一丁目,972,1543,707,836,2014,9,52
2145,春日二丁目,2022,3971,1894,2077,2014,9,99
2146,小石川一丁目,1995,3700,1706,1994,2014,9,86
2147,小石川二丁目,2084,3829,1801,2028,2014,9,87
2148,小石川三丁目,2424,4952,2347,2605,2014,9,57
2149,小石川四丁目,1698,3349,1505,1844,2014,9,63
2150,小石川五丁目,2862,5492,2518,2974,2014,9,129
2151,白山一丁目,2544,4591,2254,2337,2014,9,131
2152,白山二丁目,2164,4028,1971,2057,2014,9,181
2153,白山三丁目,525,1018,491,527,2014,9,22
2154,白山四丁目,2223,4308,2054,2254,2014,9,78
2155,白山五丁目,2041,3646,1674,1972,2014,9,130
2156,千石一丁目,1879,3853,1818,2035,2014,9,65
2157,千石二丁目,1923,3917,1857,2060,2014,9,48
2158,千石三丁目,2149,4340,2095,2245,2014,9,74
2159,千石四丁目,3055,5320,2544,2776,2014,9,163
2160,水道一丁目,1371,2535,1238,1297,2014,9,74
2161,水道二丁目,1895,3024,1531,1493,2014,9,138
2162,小日向一丁目,1090,2125,958,1167,2014,9,18
2163,小日向二丁目,1058,2374,1139,1235,2014,9,36
2164,小日向三丁目,645,1302,632,670,2014,9,35
2165,小日向四丁目,960,1796,854,942,2014,9,49
2166,大塚一丁目,552,1173,548,625,2014,9,1
2167,大塚二丁目,1051,1928,824,1104,2014,9,22
2168,大塚三丁目,2007,3400,1567,1833,2014,9,147
2169,大塚四丁目,1768,3024,1421,1603,2014,9,79
2170,大塚五丁目,2336,4260,2014,2246,2014,9,134
2171,大塚六丁目,2145,3728,1873,1855,2014,9,90
2172,関口一丁目,2488,4236,1984,2252,2014,9,136
2173,関口二丁目,451,933,428,505,2014,9,21
2174,関口三丁目,440,891,427,464,2014,9,21
2175,目白台一丁目,1277,2216,1221,995,2014,9,45
2176,目白台二丁目,1137,2103,987,1116,2014,9,50
2177,目白台三丁目,1317,2543,1200,1343,2014,9,46
2178,音羽一丁目,2337,3931,1752,2179,2014,9,73
2179,音羽二丁目,985,1774,773,1001,2014,9,22
2180,本郷一丁目,2108,4084,1876,2208,2014,9,120
2181,本郷二丁目,1737,2916,1386,1530,2014,9,96
2182,本郷三丁目,1870,2940,1379,1561,2014,9,114
2183,本郷四丁目,2201,3991,1884,2107,2014,9,83
2184,本郷五丁目,1833,3273,1679,1594,2014,9,74
2185,本郷六丁目,1087,1882,952,930,2014,9,52
2186,湯島一丁目,471,699,322,377,2014,9,22
2187,湯島二丁目,1541,2511,1272,1239,2014,9,73
2188,湯島三丁目,1802,2786,1387,1399,2014,9,150
2189,湯島四丁目,1127,2010,1019,991,2014,9,31
2190,西片一丁目,1167,2376,1119,1257,2014,9,42
2191,西片二丁目,1439,2884,1434,1450,2014,9,41
2192,向丘一丁目,1776,3256,1640,1616,2014,9,89
2193,向丘二丁目,1873,3238,1516,1722,2014,9,68
2194,弥生一丁目,239,425,214,211,2014,9,7
2195,弥生二丁目,810,1544,740,804,2014,9,33
2196,根津一丁目,1381,2467,1086,1381,2014,9,38
2197,根津二丁目,2138,3698,1756,1942,2014,9,89
2198,千駄木一丁目,708,1455,678,777,2014,9,23
2199,千駄木二丁目,2448,4329,2023,2306,2014,9,122
2200,千駄木三丁目,3632,6556,3132,3424,2014,9,171
2201,千駄木四丁目,1582,2932,1457,1475,2014,9,75
2202,千駄木五丁目,2249,4588,2209,2379,2014,9,89
2203,本駒込一丁目,2333,4531,2129,2402,2014,9,71
2204,本駒込二丁目,2532,4823,2310,2513,2014,9,112
2205,本駒込三丁目,1789,3206,1518,1688,2014,9,101
2206,本駒込四丁目,2119,4144,2013,2131,2014,9,85
2207,本駒込五丁目,2964,5527,2669,2858,2014,9,146
2208,本駒込六丁目,1705,3329,1519,1810,2014,9,76
2209,後楽一丁目,576,873,489,384,2014,10,1
2210,後楽二丁目,836,1487,750,737,2014,10,41
2211,春日一丁目,969,1541,705,836,2014,10,51
2212,春日二丁目,2013,3954,1885,2069,2014,10,84
2213,小石川一丁目,2004,3723,1714,2009,2014,10,82
2214,小石川二丁目,2087,3836,1801,2035,2014,10,77
2215,小石川三丁目,2422,4971,2354,2617,2014,10,51
2216,小石川四丁目,1697,3347,1504,1843,2014,10,67
2217,小石川五丁目,2883,5531,2543,2988,2014,10,149
2218,白山一丁目,2543,4584,2250,2334,2014,10,145
2219,白山二丁目,2160,4029,1973,2056,2014,10,181
2220,白山三丁目,523,1023,494,529,2014,10,16
2221,白山四丁目,2227,4312,2050,2262,2014,10,98
2222,白山五丁目,2039,3648,1678,1970,2014,10,124
2223,千石一丁目,1874,3845,1813,2032,2014,10,57
2224,千石二丁目,1928,3918,1860,2058,2014,10,52
2225,千石三丁目,2150,4343,2093,2250,2014,10,62
2226,千石四丁目,3058,5321,2540,2781,2014,10,158
2227,水道一丁目,1368,2544,1240,1304,2014,10,76
2228,水道二丁目,1897,3024,1532,1492,2014,10,142
2229,小日向一丁目,1128,2199,993,1206,2014,10,15
2230,小日向二丁目,1059,2372,1137,1235,2014,10,33
2231,小日向三丁目,645,1301,632,669,2014,10,34
2232,小日向四丁目,971,1814,858,956,2014,10,50
2233,大塚一丁目,555,1175,548,627,2014,10,4
2234,大塚二丁目,1054,1929,827,1102,2014,10,15
2235,大塚三丁目,1999,3386,1561,1825,2014,10,125
2236,大塚四丁目,1764,3021,1418,1603,2014,10,79
2237,大塚五丁目,2327,4255,2010,2245,2014,10,116
2238,大塚六丁目,2168,3750,1889,1861,2014,10,79
2239,関口一丁目,2490,4238,1979,2259,2014,10,131
2240,関口二丁目,476,994,457,537,2014,10,13
2241,関口三丁目,439,889,425,464,2014,10,27
2242,目白台一丁目,1296,2237,1235,1002,2014,10,38
2243,目白台二丁目,1144,2101,985,1116,2014,10,38
2244,目白台三丁目,1316,2536,1194,1342,2014,10,59
2245,音羽一丁目,2345,3950,1759,2191,2014,10,83
2246,音羽二丁目,987,1778,776,1002,2014,10,25
2247,本郷一丁目,2110,4091,1878,2213,2014,10,94
2248,本郷二丁目,1738,2927,1388,1539,2014,10,101
2249,本郷三丁目,1876,2945,1377,1568,2014,10,115
2250,本郷四丁目,2194,3992,1887,2105,2014,10,74
2251,本郷五丁目,1854,3293,1687,1606,2014,10,61
2252,本郷六丁目,1096,1894,960,934,2014,10,64
2253,湯島一丁目,472,697,323,374,2014,10,23
2254,湯島二丁目,1539,2505,1263,1242,2014,10,102
2255,湯島三丁目,1804,2801,1394,1407,2014,10,159
2256,湯島四丁目,1134,2016,1026,990,2014,10,36
2257,西片一丁目,1172,2378,1117,1261,2014,10,56
2258,西片二丁目,1435,2880,1436,1444,2014,10,40
2259,向丘一丁目,1776,3251,1644,1607,2014,10,98
2260,向丘二丁目,1878,3247,1518,1729,2014,10,72
2261,弥生一丁目,235,420,211,209,2014,10,13
2262,弥生二丁目,809,1541,741,800,2014,10,30
2263,根津一丁目,1383,2475,1091,1384,2014,10,26
2264,根津二丁目,2146,3712,1766,1946,2014,10,79
2265,千駄木一丁目,703,1451,674,777,2014,10,24
2266,千駄木二丁目,2450,4324,2031,2293,2014,10,123
2267,千駄木三丁目,3690,6628,3161,3467,2014,10,181
2268,千駄木四丁目,1585,2939,1466,1473,2014,10,90
2269,千駄木五丁目,2244,4585,2202,2383,2014,10,81
2270,本駒込一丁目,2330,4524,2127,2397,2014,10,74
2271,本駒込二丁目,2536,4821,2309,2512,2014,10,101
2272,本駒込三丁目,1787,3204,1523,1681,2014,10,101
2273,本駒込四丁目,2117,4142,2008,2134,2014,10,72
2274,本駒込五丁目,2968,5533,2669,2864,2014,10,150
2275,本駒込六丁目,1718,3364,1535,1829,2014,10,76
2276,後楽一丁目,580,872,487,385,2014,11,3
2277,後楽二丁目,829,1476,741,735,2014,11,44
2278,春日一丁目,965,1529,699,830,2014,11,53
2279,春日二丁目,2031,3974,1902,2072,2014,11,62
2280,小石川一丁目,2008,3722,1716,2006,2014,11,68
2281,小石川二丁目,2089,3841,1805,2036,2014,11,87
2282,小石川三丁目,2460,5039,2392,2647,2014,11,45
2283,小石川四丁目,1692,3340,1505,1835,2014,11,72
2284,小石川五丁目,2895,5541,2545,2996,2014,11,124
2285,白山一丁目,2552,4596,2261,2335,2014,11,130
2286,白山二丁目,2166,4044,1980,2064,2014,11,181
2287,白山三丁目,523,1021,494,527,2014,11,13
2288,白山四丁目,2228,4321,2059,2262,2014,11,92
2289,白山五丁目,2050,3662,1678,1984,2014,11,117
2290,千石一丁目,1876,3839,1805,2034,2014,11,52
2291,千石二丁目,1936,3920,1862,2058,2014,11,56
2292,千石三丁目,2144,4336,2093,2243,2014,11,55
2293,千石四丁目,3066,5332,2549,2783,2014,11,156
2294,水道一丁目,1374,2560,1247,1313,2014,11,69
2295,水道二丁目,1896,3024,1533,1491,2014,11,141
2296,小日向一丁目,1131,2199,996,1203,2014,11,21
2297,小日向二丁目,1060,2371,1135,1236,2014,11,31
2298,小日向三丁目,643,1298,627,671,2014,11,30
2299,小日向四丁目,977,1824,867,957,2014,11,41
2300,大塚一丁目,561,1189,558,631,2014,11,7
2301,大塚二丁目,1049,1926,824,1102,2014,11,20
2302,大塚三丁目,1997,3379,1558,1821,2014,11,117
2303,大塚四丁目,1776,3031,1430,1601,2014,11,64
2304,大塚五丁目,2339,4262,2015,2247,2014,11,91
2305,大塚六丁目,2167,3757,1893,1864,2014,11,82
2306,関口一丁目,2492,4236,1975,2261,2014,11,121
2307,関口二丁目,476,998,461,537,2014,11,20
2308,関口三丁目,437,886,423,463,2014,11,23
2309,目白台一丁目,1301,2246,1242,1004,2014,11,38
2310,目白台二丁目,1161,2125,995,1130,2014,11,30
2311,目白台三丁目,1326,2550,1205,1345,2014,11,36
2312,音羽一丁目,2339,3945,1752,2193,2014,11,72
2313,音羽二丁目,982,1773,775,998,2014,11,31
2314,本郷一丁目,2108,4099,1883,2216,2014,11,76
2315,本郷二丁目,1732,2926,1379,1547,2014,11,89
2316,本郷三丁目,1885,2963,1384,1579,2014,11,117
2317,本郷四丁目,2209,3998,1892,2106,2014,11,74
2318,本郷五丁目,1851,3300,1696,1604,2014,11,53
2319,本郷六丁目,1097,1891,957,934,2014,11,80
2320,湯島一丁目,471,697,322,375,2014,11,12
2321,湯島二丁目,1538,2510,1267,1243,2014,11,91
2322,湯島三丁目,1803,2803,1398,1405,2014,11,149
2323,湯島四丁目,1132,2012,1022,990,2014,11,40
2324,西片一丁目,1182,2389,1120,1269,2014,11,34
2325,西片二丁目,1449,2903,1449,1454,2014,11,46
2326,向丘一丁目,1783,3250,1641,1609,2014,11,77
2327,向丘二丁目,1873,3238,1514,1724,2014,11,82
2328,弥生一丁目,237,422,213,209,2014,11,14
2329,弥生二丁目,816,1549,748,801,2014,11,17
2330,根津一丁目,1392,2488,1101,1387,2014,11,24
2331,根津二丁目,2161,3734,1778,1956,2014,11,69
2332,千駄木一丁目,705,1449,672,777,2014,11,25
2333,千駄木二丁目,2465,4344,2039,2305,2014,11,118
2334,千駄木三丁目,3692,6625,3161,3464,2014,11,189
2335,千駄木四丁目,1583,2949,1473,1476,2014,11,100
2336,千駄木五丁目,2243,4581,2197,2384,2014,11,79
2337,本駒込一丁目,2330,4523,2125,2398,2014,11,79
2338,本駒込二丁目,2556,4853,2333,2520,2014,11,100
2339,本駒込三丁目,1793,3218,1535,1683,2014,11,84
2340,本駒込四丁目,2116,4142,2007,2135,2014,11,65
2341,本駒込五丁目,2981,5544,2669,2875,2014,11,192
2342,本駒込六丁目,1739,3395,1545,1850,2014,11,71
2343,後楽一丁目,561,857,468,389,2014,12,6
2344,後楽二丁目,825,1466,736,730,2014,12,51
2345,春日一丁目,971,1539,704,835,2014,12,46
2346,春日二丁目,2038,3992,1910,2082,2014,12,77
2347,小石川一丁目,2008,3717,1717,2000,2014,12,77
2348,小石川二丁目,2101,3860,1820,2040,2014,12,77
2349,小石川三丁目,2460,5044,2398,2646,2014,12,54
2350,小石川四丁目,1693,3344,1508,1836,2014,12,61
2351,小石川五丁目,2896,5540,2544,2996,2014,12,118
2352,白山一丁目,2554,4597,2257,2340,2014,12,141
2353,白山二丁目,2180,4059,1991,2068,2014,12,146
2354,白山三丁目,524,1022,497,525,2014,12,10
2355,白山四丁目,2229,4320,2059,2261,2014,12,86
2356,白山五丁目,2040,3651,1670,1981,2014,12,114
2357,千石一丁目,1884,3848,1807,2041,2014,12,59
2358,千石二丁目,1932,3916,1862,2054,2014,12,72
2359,千石三丁目,2149,4353,2098,2255,2014,12,59
2360,千石四丁目,3067,5338,2558,2780,2014,12,136
2361,水道一丁目,1373,2547,1241,1306,2014,12,76
2362,水道二丁目,1897,3024,1530,1494,2014,12,120
2363,小日向一丁目,1139,2211,1004,1207,2014,12,20
2364,小日向二丁目,1057,2363,1131,1232,2014,12,32
2365,小日向三丁目,648,1306,630,676,2014,12,24
2366,小日向四丁目,976,1822,865,957,2014,12,41
2367,大塚一丁目,556,1180,552,628,2014,12,7
2368,大塚二丁目,1040,1921,819,1102,2014,12,10
2369,大塚三丁目,1996,3377,1563,1814,2014,12,109
2370,大塚四丁目,1774,3027,1424,1603,2014,12,68
2371,大塚五丁目,2343,4257,2020,2237,2014,12,80
2372,大塚六丁目,2170,3763,1899,1864,2014,12,74
2373,関口一丁目,2485,4230,1975,2255,2014,12,131
2374,関口二丁目,474,992,459,533,2014,12,26
2375,関口三丁目,435,889,427,462,2014,12,13
2376,目白台一丁目,1296,2241,1233,1008,2014,12,39
2377,目白台二丁目,1167,2132,1001,1131,2014,12,26
2378,目白台三丁目,1329,2553,1202,1351,2014,12,38
2379,音羽一丁目,2341,3945,1755,2190,2014,12,92
2380,音羽二丁目,976,1765,774,991,2014,12,40
2381,本郷一丁目,2107,4117,1892,2225,2014,12,63
2382,本郷二丁目,1729,2922,1375,1547,2014,12,88
2383,本郷三丁目,1883,2961,1385,1576,2014,12,108
2384,本郷四丁目,2213,4002,1895,2107,2014,12,71
2385,本郷五丁目,1853,3300,1697,1603,2014,12,59
2386,本郷六丁目,1098,1892,958,934,2014,12,67
2387,湯島一丁目,465,689,319,370,2014,12,19
2388,湯島二丁目,1543,2535,1277,1258,2014,12,83
2389,湯島三丁目,1800,2801,1389,1412,2014,12,164
2390,湯島四丁目,1116,1997,1008,989,2014,12,37
2391,西片一丁目,1184,2385,1117,1268,2014,12,36
2392,西片二丁目,1452,2908,1451,1457,2014,12,40
2393,向丘一丁目,1788,3261,1644,1617,2014,12,86
2394,向丘二丁目,1873,3238,1517,1721,2014,12,78
2395,弥生一丁目,236,421,213,208,2014,12,9
2396,弥生二丁目,828,1562,754,808,2014,12,26
2397,根津一丁目,1396,2497,1109,1388,2014,12,31
2398,根津二丁目,2156,3723,1769,1954,2014,12,71
2399,千駄木一丁目,704,1453,675,778,2014,12,24
2400,千駄木二丁目,2465,4337,2040,2297,2014,12,139
2401,千駄木三丁目,3692,6624,3158,3466,2014,12,147
2402,千駄木四丁目,1582,2951,1478,1473,2014,12,97
2403,千駄木五丁目,2238,4586,2202,2384,2014,12,74
2404,本駒込一丁目,2335,4533,2136,2397,2014,12,95
2405,本駒込二丁目,2564,4877,2353,2524,2014,12,95
2406,本駒込三丁目,1799,3230,1541,1689,2014,12,74
2407,本駒込四丁目,2116,4138,2005,2133,2014,12,60
2408,本駒込五丁目,2971,5541,2665,2876,2014,12,191
2409,本駒込六丁目,1737,3391,1540,1851,2014,12,68
2410,後楽一丁目,573,880,492,388,2013,1,11
2411,後楽二丁目,841,1492,743,749,2013,1,40
2412,春日一丁目,963,1534,711,823,2013,1,85
2413,春日二丁目,1917,3789,1822,1967,2013,1,102
2414,小石川一丁目,1947,3592,1639,1953,2013,1,87
2415,小石川二丁目,2047,3725,1748,1977,2013,1,84
2416,小石川三丁目,2396,4900,2331,2569,2013,1,77
2417,小石川四丁目,1692,3377,1517,1860,2013,1,83
2418,小石川五丁目,2827,5341,2475,2866,2013,1,147
2419,白山一丁目,2523,4582,2221,2361,2013,1,184
2420,白山二丁目,2124,3961,1935,2026,2013,1,123
2421,白山三丁目,528,1020,482,538,2013,1,25
2422,白山四丁目,2232,4308,2054,2254,2013,1,103
2423,白山五丁目,2020,3618,1656,1962,2013,1,163
2424,千石一丁目,1809,3787,1798,1989,2013,1,67
2425,千石二丁目,1924,3912,1866,2046,2013,1,74
2426,千石三丁目,2080,4199,2043,2156,2013,1,70
2427,千石四丁目,2969,5134,2440,2694,2013,1,166
2428,水道一丁目,1330,2472,1206,1266,2013,1,121
2429,水道二丁目,1811,2881,1478,1403,2013,1,116
2430,小日向一丁目,1041,2064,939,1125,2013,1,30
2431,小日向二丁目,1093,2469,1195,1274,2013,1,38
2432,小日向三丁目,642,1295,647,648,2013,1,24
2433,小日向四丁目,843,1516,722,794,2013,1,54
2434,大塚一丁目,546,1184,555,629,2013,1,6
2435,大塚二丁目,979,1804,783,1021,2013,1,24
2436,大塚三丁目,1911,3228,1482,1746,2013,1,150
2437,大塚四丁目,1654,2876,1307,1569,2013,1,85
2438,大塚五丁目,2253,4121,1974,2147,2013,1,112
2439,大塚六丁目,2107,3659,1857,1802,2013,1,119
2440,関口一丁目,2324,4067,1922,2145,2013,1,177
2441,関口二丁目,438,895,420,475,2013,1,20
2442,関口三丁目,444,927,446,481,2013,1,22
2443,目白台一丁目,1285,2193,1221,972,2013,1,51
2444,目白台二丁目,1104,1996,928,1068,2013,1,42
2445,目白台三丁目,1286,2457,1151,1306,2013,1,39
2446,音羽一丁目,2173,3733,1636,2097,2013,1,111
2447,音羽二丁目,957,1708,732,976,2013,1,39
2448,本郷一丁目,1969,3782,1753,2029,2013,1,129
2449,本郷二丁目,1739,2920,1356,1564,2013,1,140
2450,本郷三丁目,1720,2760,1299,1461,2013,1,67
2451,本郷四丁目,2082,3767,1765,2002,2013,1,98
2452,本郷五丁目,1826,3248,1663,1585,2013,1,48
2453,本郷六丁目,1005,1661,861,800,2013,1,55
2454,湯島一丁目,450,686,296,390,2013,1,38
2455,湯島二丁目,1454,2398,1217,1181,2013,1,116
2456,湯島三丁目,1835,2924,1432,1492,2013,1,210
2457,湯島四丁目,1116,2032,1029,1003,2013,1,46
2458,西片一丁目,1143,2348,1112,1236,2013,1,56
2459,西片二丁目,1441,2863,1435,1428,2013,1,71
2460,向丘一丁目,1780,3275,1642,1633,2013,1,95
2461,向丘二丁目,1800,3168,1514,1654,2013,1,144
2462,弥生一丁目,257,459,235,224,2013,1,15
2463,弥生二丁目,819,1545,748,797,2013,1,29
2464,根津一丁目,1274,2329,1041,1288,2013,1,47
2465,根津二丁目,2128,3703,1741,1962,2013,1,60
2466,千駄木一丁目,715,1461,678,783,2013,1,26
2467,千駄木二丁目,2422,4322,2017,2305,2013,1,119
2468,千駄木三丁目,3522,6353,3017,3336,2013,1,187
2469,千駄木四丁目,1591,2924,1449,1475,2013,1,93
2470,千駄木五丁目,2265,4568,2187,2381,2013,1,77
2471,本駒込一丁目,2196,4284,2005,2279,2013,1,147
2472,本駒込二丁目,2422,4551,2183,2368,2013,1,109
2473,本駒込三丁目,1774,3160,1499,1661,2013,1,83
2474,本駒込四丁目,2077,4081,1965,2116,2013,1,118
2475,本駒込五丁目,2899,5372,2586,2786,2013,1,179
2476,本駒込六丁目,1590,3186,1445,1741,2013,1,74
2477,後楽一丁目,559,862,479,383,2013,2,11
2478,後楽二丁目,838,1483,738,745,2013,2,36
2479,春日一丁目,964,1535,709,826,2013,2,80
2480,春日二丁目,1918,3799,1826,1973,2013,2,103
2481,小石川一丁目,1952,3605,1647,1958,2013,2,87
2482,小石川二丁目,2058,3739,1758,1981,2013,2,73
2483,小石川三丁目,2409,4914,2343,2571,2013,2,97
2484,小石川四丁目,1700,3384,1519,1865,2013,2,95
2485,小石川五丁目,2836,5350,2477,2873,2013,2,174
2486,白山一丁目,2521,4577,2226,2351,2013,2,176
2487,白山二丁目,2144,3985,1939,2046,2013,2,126
2488,白山三丁目,524,1015,481,534,2013,2,23
2489,白山四丁目,2229,4305,2051,2254,2013,2,82
2490,白山五丁目,2033,3651,1670,1981,2013,2,140
2491,千石一丁目,1817,3796,1800,1996,2013,2,63
2492,千石二丁目,1933,3931,1874,2057,2013,2,65
2493,千石三丁目,2072,4177,2038,2139,2013,2,76
2494,千石四丁目,2964,5141,2444,2697,2013,2,165
2495,水道一丁目,1333,2475,1211,1264,2013,2,117
2496,水道二丁目,1825,2900,1486,1414,2013,2,118
2497,小日向一丁目,1046,2068,943,1125,2013,2,33
2498,小日向二丁目,1090,2468,1197,1271,2013,2,37
2499,小日向三丁目,643,1296,646,650,2013,2,18
2500,小日向四丁目,838,1516,725,791,2013,2,56
2501,大塚一丁目,545,1182,554,628,2013,2,4
2502,大塚二丁目,979,1806,784,1022,2013,2,23
2503,大塚三丁目,1896,3209,1471,1738,2013,2,172
2504,大塚四丁目,1658,2887,1312,1575,2013,2,84
2505,大塚五丁目,2262,4130,1979,2151,2013,2,131
2506,大塚六丁目,2100,3657,1859,1798,2013,2,104
2507,関口一丁目,2341,4090,1932,2158,2013,2,177
2508,関口二丁目,441,898,420,478,2013,2,23
2509,関口三丁目,440,924,444,480,2013,2,24
2510,目白台一丁目,1281,2190,1223,967,2013,2,47
2511,目白台二丁目,1104,1994,926,1068,2013,2,47
2512,目白台三丁目,1284,2454,1151,1303,2013,2,45
2513,音羽一丁目,2179,3744,1640,2104,2013,2,123
2514,音羽二丁目,961,1709,731,978,2013,2,32
2515,本郷一丁目,1966,3777,1749,2028,2013,2,115
2516,本郷二丁目,1751,2936,1366,1570,2013,2,152
2517,本郷三丁目,1730,2768,1300,1468,2013,2,71
2518,本郷四丁目,2078,3758,1761,1997,2013,2,72
2519,本郷五丁目,1826,3256,1663,1593,2013,2,58
2520,本郷六丁目,1001,1653,857,796,2013,2,79
2521,湯島一丁目,450,687,297,390,2013,2,40
2522,湯島二丁目,1447,2391,1215,1176,2013,2,115
2523,湯島三丁目,1846,2939,1436,1503,2013,2,204
2524,湯島四丁目,1137,2051,1043,1008,2013,2,47
2525,西片一丁目,1150,2354,1117,1237,2013,2,53
2526,西片二丁目,1437,2857,1429,1428,2013,2,69
2527,向丘一丁目,1771,3270,1641,1629,2013,2,89
2528,向丘二丁目,1814,3183,1523,1660,2013,2,160
2529,弥生一丁目,256,457,234,223,2013,2,12
2530,弥生二丁目,823,1553,751,802,2013,2,31
2531,根津一丁目,1283,2339,1043,1296,2013,2,35
2532,根津二丁目,2133,3712,1753,1959,2013,2,63
2533,千駄木一丁目,714,1460,679,781,2013,2,34
2534,千駄木二丁目,2417,4311,2011,2300,2013,2,111
2535,千駄木三丁目,3515,6353,3021,3332,2013,2,205
2536,千駄木四丁目,1589,2920,1449,1471,2013,2,84
2537,千駄木五丁目,2265,4565,2193,2372,2013,2,81
2538,本駒込一丁目,2188,4272,1997,2275,2013,2,133
2539,本駒込二丁目,2423,4548,2179,2369,2013,2,86
2540,本駒込三丁目,1772,3154,1499,1655,2013,2,85
2541,本駒込四丁目,2068,4075,1964,2111,2013,2,117
2542,本駒込五丁目,2882,5356,2578,2778,2013,2,179
2543,本駒込六丁目,1589,3179,1442,1737,2013,2,82
2544,後楽一丁目,557,860,480,380,2013,3,14
2545,後楽二丁目,833,1474,736,738,2013,3,53
2546,春日一丁目,964,1536,709,827,2013,3,65
2547,春日二丁目,1950,3906,1876,2030,2013,3,98
2548,小石川一丁目,1953,3608,1645,1963,2013,3,90
2549,小石川二丁目,2060,3750,1767,1983,2013,3,84
2550,小石川三丁目,2405,4919,2343,2576,2013,3,101
2551,小石川四丁目,1693,3360,1505,1855,2013,3,106
2552,小石川五丁目,2841,5348,2473,2875,2013,3,165
2553,白山一丁目,2512,4554,2224,2330,2013,3,178
2554,白山二丁目,2156,4002,1946,2056,2013,3,127
2555,白山三丁目,525,1011,476,535,2013,3,27
2556,白山四丁目,2218,4285,2048,2237,2013,3,71
2557,白山五丁目,2046,3670,1681,1989,2013,3,116
2558,千石一丁目,1813,3787,1789,1998,2013,3,73
2559,千石二丁目,1929,3932,1875,2057,2013,3,70
2560,千石三丁目,2090,4199,2052,2147,2013,3,60
2561,千石四丁目,2968,5143,2445,2698,2013,3,148
2562,水道一丁目,1328,2469,1205,1264,2013,3,94
2563,水道二丁目,1822,2910,1490,1420,2013,3,146
2564,小日向一丁目,1037,2045,929,1116,2013,3,39
2565,小日向二丁目,1091,2474,1202,1272,2013,3,32
2566,小日向三丁目,647,1299,647,652,2013,3,26
2567,小日向四丁目,840,1522,732,790,2013,3,73
2568,大塚一丁目,541,1175,553,622,2013,3,8
2569,大塚二丁目,975,1807,788,1019,2013,3,21
2570,大塚三丁目,1903,3225,1481,1744,2013,3,172
2571,大塚四丁目,1661,2893,1320,1573,2013,3,82
2572,大塚五丁目,2252,4117,1970,2147,2013,3,131
2573,大塚六丁目,2111,3670,1869,1801,2013,3,120
2574,関口一丁目,2323,4060,1908,2152,2013,3,160
2575,関口二丁目,445,908,424,484,2013,3,17
2576,関口三丁目,442,929,449,480,2013,3,23
2577,目白台一丁目,1265,2177,1207,970,2013,3,43
2578,目白台二丁目,1104,1992,927,1065,2013,3,45
2579,目白台三丁目,1289,2457,1156,1301,2013,3,39
2580,音羽一丁目,2182,3737,1638,2099,2013,3,124
2581,音羽二丁目,956,1699,725,974,2013,3,43
2582,本郷一丁目,1976,3804,1764,2040,2013,3,140
2583,本郷二丁目,1746,2928,1362,1566,2013,3,149
2584,本郷三丁目,1736,2776,1309,1467,2013,3,87
2585,本郷四丁目,2080,3758,1762,1996,2013,3,77
2586,本郷五丁目,1815,3242,1659,1583,2013,3,78
2587,本郷六丁目,1006,1661,857,804,2013,3,66
2588,湯島一丁目,450,688,296,392,2013,3,36
2589,湯島二丁目,1432,2376,1211,1165,2013,3,122
2590,湯島三丁目,1840,2927,1437,1490,2013,3,225
2591,湯島四丁目,1133,2043,1038,1005,2013,3,59
2592,西片一丁目,1150,2363,1124,1239,2013,3,42
2593,西片二丁目,1440,2863,1435,1428,2013,3,82
2594,向丘一丁目,1768,3271,1636,1635,2013,3,106
2595,向丘二丁目,1822,3201,1530,1671,2013,3,128
2596,弥生一丁目,252,452,231,221,2013,3,14
2597,弥生二丁目,827,1556,754,802,2013,3,37
2598,根津一丁目,1280,2334,1044,1290,2013,3,36
2599,根津二丁目,2133,3711,1753,1958,2013,3,59
2600,千駄木一丁目,707,1453,676,777,2013,3,38
2601,千駄木二丁目,2420,4310,2010,2300,2013,3,129
2602,千駄木三丁目,3512,6354,3016,3338,2013,3,195
2603,千駄木四丁目,1590,2912,1442,1470,2013,3,74
2604,千駄木五丁目,2265,4572,2195,2377,2013,3,95
2605,本駒込一丁目,2194,4278,2003,2275,2013,3,136
2606,本駒込二丁目,2438,4586,2202,2384,2013,3,82
2607,本駒込三丁目,1772,3151,1497,1654,2013,3,91
2608,本駒込四丁目,2079,4084,1969,2115,2013,3,125
2609,本駒込五丁目,2870,5341,2571,2770,2013,3,176
2610,本駒込六丁目,1587,3182,1440,1742,2013,3,89
2611,後楽一丁目,558,856,479,377,2013,4,18
2612,後楽二丁目,835,1478,737,741,2013,4,55
2613,春日一丁目,971,1545,718,827,2013,4,70
2614,春日二丁目,1959,3911,1881,2030,2013,4,81
2615,小石川一丁目,1971,3626,1657,1969,2013,4,96
2616,小石川二丁目,2067,3753,1769,1984,2013,4,80
2617,小石川三丁目,2395,4908,2333,2575,2013,4,85
2618,小石川四丁目,1693,3370,1505,1865,2013,4,113
2619,小石川五丁目,2845,5353,2479,2874,2013,4,156
2620,白山一丁目,2525,4576,2234,2342,2013,4,173
2621,白山二丁目,2170,4019,1952,2067,2013,4,134
2622,白山三丁目,518,1006,476,530,2013,4,19
2623,白山四丁目,2236,4311,2058,2253,2013,4,69
2624,白山五丁目,2080,3713,1695,2018,2013,4,121
2625,千石一丁目,1815,3775,1777,1998,2013,4,96
2626,千石二丁目,1946,3966,1892,2074,2013,4,77
2627,千石三丁目,2112,4222,2074,2148,2013,4,56
2628,千石四丁目,3021,5211,2461,2750,2013,4,153
2629,水道一丁目,1340,2490,1212,1278,2013,4,76
2630,水道二丁目,1816,2899,1483,1416,2013,4,158
2631,小日向一丁目,1042,2061,937,1124,2013,4,27
2632,小日向二丁目,1084,2453,1183,1270,2013,4,30
2633,小日向三丁目,654,1295,645,650,2013,4,22
2634,小日向四丁目,850,1541,735,806,2013,4,63
2635,大塚一丁目,528,1165,549,616,2013,4,6
2636,大塚二丁目,979,1817,793,1024,2013,4,16
2637,大塚三丁目,1916,3259,1494,1765,2013,4,166
2638,大塚四丁目,1659,2888,1325,1563,2013,4,63
2639,大塚五丁目,2278,4149,1980,2169,2013,4,100
2640,大塚六丁目,2127,3684,1875,1809,2013,4,98
2641,関口一丁目,2339,4072,1916,2156,2013,4,181
2642,関口二丁目,437,895,418,477,2013,4,12
2643,関口三丁目,437,915,444,471,2013,4,19
2644,目白台一丁目,1271,2186,1218,968,2013,4,36
2645,目白台二丁目,1096,1990,929,1061,2013,4,45
2646,目白台三丁目,1273,2446,1155,1291,2013,4,29
2647,音羽一丁目,2182,3732,1636,2096,2013,4,113
2648,音羽二丁目,958,1702,721,981,2013,4,39
2649,本郷一丁目,1995,3819,1768,2051,2013,4,113
2650,本郷二丁目,1751,2946,1374,1572,2013,4,175
2651,本郷三丁目,1740,2789,1309,1480,2013,4,90
2652,本郷四丁目,2093,3787,1779,2008,2013,4,67
2653,本郷五丁目,1827,3237,1657,1580,2013,4,81
2654,本郷六丁目,1019,1691,870,821,2013,4,68
2655,湯島一丁目,444,676,291,385,2013,4,45
2656,湯島二丁目,1441,2387,1215,1172,2013,4,95
2657,湯島三丁目,1825,2889,1426,1463,2013,4,191
2658,湯島四丁目,1138,2041,1037,1004,2013,4,70
2659,西片一丁目,1152,2371,1128,1243,2013,4,39
2660,西片二丁目,1426,2857,1433,1424,2013,4,92
2661,向丘一丁目,1745,3256,1622,1634,2013,4,134
2662,向丘二丁目,1862,3233,1525,1708,2013,4,90
2663,弥生一丁目,248,439,225,214,2013,4,12
2664,弥生二丁目,812,1537,740,797,2013,4,41
2665,根津一丁目,1280,2342,1051,1291,2013,4,38
2666,根津二丁目,2141,3732,1765,1967,2013,4,58
2667,千駄木一丁目,708,1454,676,778,2013,4,28
2668,千駄木二丁目,2432,4314,2021,2293,2013,4,129
2669,千駄木三丁目,3516,6358,3016,3342,2013,4,187
2670,千駄木四丁目,1595,2923,1448,1475,2013,4,77
2671,千駄木五丁目,2264,4564,2191,2373,2013,4,94
2672,本駒込一丁目,2189,4260,1996,2264,2013,4,142
2673,本駒込二丁目,2469,4677,2245,2432,2013,4,93
2674,本駒込三丁目,1789,3168,1501,1667,2013,4,95
2675,本駒込四丁目,2084,4100,1976,2124,2013,4,153
2676,本駒込五丁目,2852,5331,2576,2755,2013,4,196
2677,本駒込六丁目,1587,3176,1430,1746,2013,4,82
2678,後楽一丁目,563,861,481,380,2013,5,9
2679,後楽二丁目,838,1489,743,746,2013,5,55
2680,春日一丁目,962,1525,708,817,2013,5,58
2681,春日二丁目,1962,3904,1881,2023,2013,5,77
2682,小石川一丁目,2011,3688,1677,2011,2013,5,80
2683,小石川二丁目,2081,3761,1774,1987,2013,5,77
2684,小石川三丁目,2409,4932,2345,2587,2013,5,67
2685,小石川四丁目,1689,3364,1496,1868,2013,5,97
2686,小石川五丁目,2866,5398,2504,2894,2013,5,132
2687,白山一丁目,2548,4603,2255,2348,2013,5,166
2688,白山二丁目,2174,4021,1954,2067,2013,5,129
2689,白山三丁目,519,1008,478,530,2013,5,20
2690,白山四丁目,2236,4294,2045,2249,2013,5,71
2691,白山五丁目,2100,3760,1720,2040,2013,5,109
2692,千石一丁目,1818,3769,1770,1999,2013,5,77
2693,千石二丁目,1946,3962,1883,2079,2013,5,78
2694,千石三丁目,2112,4225,2060,2165,2013,5,86
2695,千石四丁目,3045,5263,2498,2765,2013,5,146
2696,水道一丁目,1341,2485,1207,1278,2013,5,88
2697,水道二丁目,1801,2879,1472,1407,2013,5,144
2698,小日向一丁目,1050,2066,944,1122,2013,5,26
2699,小日向二丁目,1081,2436,1174,1262,2013,5,28
2700,小日向三丁目,657,1304,646,658,2013,5,23
2701,小日向四丁目,855,1545,735,810,2013,5,63
2702,大塚一丁目,536,1163,546,617,2013,5,6
2703,大塚二丁目,987,1829,794,1035,2013,5,16
2704,大塚三丁目,1926,3266,1494,1772,2013,5,171
2705,大塚四丁目,1667,2903,1332,1571,2013,5,50
2706,大塚五丁目,2293,4177,1989,2188,2013,5,107
2707,大塚六丁目,2144,3694,1887,1807,2013,5,88
2708,関口一丁目,2378,4127,1940,2187,2013,5,166
2709,関口二丁目,441,903,423,480,2013,5,7
2710,関口三丁目,438,915,441,474,2013,5,16
2711,目白台一丁目,1330,2245,1277,968,2013,5,41
2712,目白台二丁目,1106,2020,946,1074,2013,5,46
2713,目白台三丁目,1290,2460,1161,1299,2013,5,36
2714,音羽一丁目,2180,3723,1633,2090,2013,5,99
2715,音羽二丁目,979,1732,733,999,2013,5,36
2716,本郷一丁目,2005,3837,1774,2063,2013,5,104
2717,本郷二丁目,1761,2951,1375,1576,2013,5,155
2718,本郷三丁目,1743,2795,1310,1485,2013,5,90
2719,本郷四丁目,2098,3802,1783,2019,2013,5,62
2720,本郷五丁目,1833,3243,1667,1576,2013,5,73
2721,本郷六丁目,1027,1689,875,814,2013,5,64
2722,湯島一丁目,444,672,290,382,2013,5,50
2723,湯島二丁目,1450,2393,1224,1169,2013,5,93
2724,湯島三丁目,1828,2885,1429,1456,2013,5,198
2725,湯島四丁目,1151,2059,1054,1005,2013,5,81
2726,西片一丁目,1157,2370,1119,1251,2013,5,38
2727,西片二丁目,1425,2847,1424,1423,2013,5,85
2728,向丘一丁目,1779,3283,1647,1636,2013,5,131
2729,向丘二丁目,1883,3258,1528,1730,2013,5,97
2730,弥生一丁目,255,448,225,223,2013,5,10
2731,弥生二丁目,820,1545,742,803,2013,5,42
2732,根津一丁目,1287,2337,1053,1284,2013,5,32
2733,根津二丁目,2124,3705,1752,1953,2013,5,68
2734,千駄木一丁目,717,1464,680,784,2013,5,30
2735,千駄木二丁目,2443,4327,2026,2301,2013,5,124
2736,千駄木三丁目,3551,6412,3051,3361,2013,5,173
2737,千駄木四丁目,1602,2936,1455,1481,2013,5,69
2738,千駄木五丁目,2261,4561,2186,2375,2013,5,87
2739,本駒込一丁目,2222,4301,2025,2276,2013,5,138
2740,本駒込二丁目,2491,4713,2261,2452,2013,5,100
2741,本駒込三丁目,1775,3150,1491,1659,2013,5,88
2742,本駒込四丁目,2085,4093,1975,2118,2013,5,134
2743,本駒込五丁目,2860,5342,2583,2759,2013,5,195
2744,本駒込六丁目,1613,3214,1456,1758,2013,5,67
2745,後楽一丁目,548,848,465,383,2013,6,10
2746,後楽二丁目,839,1493,750,743,2013,6,54
2747,春日一丁目,965,1527,706,821,2013,6,54
2748,春日二丁目,1968,3896,1875,2021,2013,6,118
2749,小石川一丁目,2026,3713,1695,2018,2013,6,81
2750,小石川二丁目,2091,3787,1787,2000,2013,6,85
2751,小石川三丁目,2417,4945,2352,2593,2013,6,83
2752,小石川四丁目,1698,3366,1493,1873,2013,6,97
2753,小石川五丁目,2871,5419,2518,2901,2013,6,117
2754,白山一丁目,2545,4586,2252,2334,2013,6,153
2755,白山二丁目,2156,3993,1941,2052,2013,6,148
2756,白山三丁目,520,1020,487,533,2013,6,23
2757,白山四丁目,2236,4303,2045,2258,2013,6,70
2758,白山五丁目,2097,3760,1725,2035,2013,6,94
2759,千石一丁目,1824,3771,1770,2001,2013,6,59
2760,千石二丁目,1944,3962,1878,2084,2013,6,74
2761,千石三丁目,2126,4249,2070,2179,2013,6,81
2762,千石四丁目,3046,5283,2506,2777,2013,6,131
2763,水道一丁目,1344,2486,1211,1275,2013,6,87
2764,水道二丁目,1802,2890,1477,1413,2013,6,132
2765,小日向一丁目,1065,2083,946,1137,2013,6,26
2766,小日向二丁目,1072,2424,1173,1251,2013,6,28
2767,小日向三丁目,658,1303,642,661,2013,6,21
2768,小日向四丁目,846,1538,728,810,2013,6,63
2769,大塚一丁目,543,1177,553,624,2013,6,8
2770,大塚二丁目,993,1836,796,1040,2013,6,22
2771,大塚三丁目,1931,3273,1499,1774,2013,6,158
2772,大塚四丁目,1667,2899,1332,1567,2013,6,50
2773,大塚五丁目,2291,4179,1989,2190,2013,6,112
2774,大塚六丁目,2137,3695,1887,1808,2013,6,91
2775,関口一丁目,2403,4154,1948,2206,2013,6,170
2776,関口二丁目,446,910,425,485,2013,6,13
2777,関口三丁目,436,917,440,477,2013,6,16
2778,目白台一丁目,1325,2246,1273,973,2013,6,42
2779,目白台二丁目,1100,2017,941,1076,2013,6,44
2780,目白台三丁目,1290,2460,1164,1296,2013,6,37
2781,音羽一丁目,2174,3720,1635,2085,2013,6,122
2782,音羽二丁目,980,1736,736,1000,2013,6,36
2783,本郷一丁目,1992,3824,1760,2064,2013,6,113
2784,本郷二丁目,1760,2963,1383,1580,2013,6,125
2785,本郷三丁目,1768,2844,1329,1515,2013,6,91
2786,本郷四丁目,2093,3804,1783,2021,2013,6,75
2787,本郷五丁目,1833,3251,1676,1575,2013,6,87
2788,本郷六丁目,1039,1725,897,828,2013,6,55
2789,湯島一丁目,444,670,288,382,2013,6,35
2790,湯島二丁目,1454,2392,1218,1174,2013,6,96
2791,湯島三丁目,1841,2902,1439,1463,2013,6,191
2792,湯島四丁目,1144,2045,1047,998,2013,6,75
2793,西片一丁目,1165,2385,1123,1262,2013,6,44
2794,西片二丁目,1430,2861,1429,1432,2013,6,70
2795,向丘一丁目,1785,3282,1650,1632,2013,6,124
2796,向丘二丁目,1890,3266,1534,1732,2013,6,81
2797,弥生一丁目,253,443,223,220,2013,6,4
2798,弥生二丁目,818,1540,741,799,2013,6,36
2799,根津一丁目,1289,2340,1051,1289,2013,6,39
2800,根津二丁目,2136,3722,1761,1961,2013,6,64
2801,千駄木一丁目,714,1457,674,783,2013,6,30
2802,千駄木二丁目,2441,4330,2027,2303,2013,6,109
2803,千駄木三丁目,3543,6410,3053,3357,2013,6,162
2804,千駄木四丁目,1603,2939,1456,1483,2013,6,81
2805,千駄木五丁目,2247,4553,2179,2374,2013,6,92
2806,本駒込一丁目,2218,4297,2022,2275,2013,6,122
2807,本駒込二丁目,2489,4706,2259,2447,2013,6,100
2808,本駒込三丁目,1775,3150,1493,1657,2013,6,79
2809,本駒込四丁目,2085,4094,1976,2118,2013,6,116
2810,本駒込五丁目,2867,5363,2590,2773,2013,6,179
2811,本駒込六丁目,1603,3202,1454,1748,2013,6,76
2812,後楽一丁目,553,860,474,386,2013,7,10
2813,後楽二丁目,838,1490,750,740,2013,7,62
2814,春日一丁目,966,1531,709,822,2013,7,65
2815,春日二丁目,1965,3886,1863,2023,2013,7,113
2816,小石川一丁目,2022,3710,1693,2017,2013,7,82
2817,小石川二丁目,2100,3798,1792,2006,2013,7,77
2818,小石川三丁目,2417,4948,2352,2596,2013,7,75
2819,小石川四丁目,1699,3362,1491,1871,2013,7,90
2820,小石川五丁目,2862,5417,2518,2899,2013,7,119
2821,白山一丁目,2536,4572,2243,2329,2013,7,146
2822,白山二丁目,2154,3985,1939,2046,2013,7,132
2823,白山三丁目,520,1021,489,532,2013,7,24
2824,白山四丁目,2229,4303,2044,2259,2013,7,71
2825,白山五丁目,2089,3732,1718,2014,2013,7,94
2826,千石一丁目,1832,3784,1777,2007,2013,7,50
2827,千石二丁目,1938,3947,1872,2075,2013,7,70
2828,千石三丁目,2128,4255,2076,2179,2013,7,95
2829,千石四丁目,3043,5286,2515,2771,2013,7,153
2830,水道一丁目,1341,2478,1205,1273,2013,7,89
2831,水道二丁目,1794,2886,1472,1414,2013,7,160
2832,小日向一丁目,1066,2087,951,1136,2013,7,18
2833,小日向二丁目,1070,2419,1169,1250,2013,7,27
2834,小日向三丁目,660,1308,647,661,2013,7,20
2835,小日向四丁目,837,1525,721,804,2013,7,58
2836,大塚一丁目,545,1178,549,629,2013,7,8
2837,大塚二丁目,996,1846,804,1042,2013,7,15
2838,大塚三丁目,1921,3260,1496,1764,2013,7,171
2839,大塚四丁目,1668,2904,1335,1569,2013,7,71
2840,大塚五丁目,2280,4171,1984,2187,2013,7,122
2841,大塚六丁目,2126,3673,1874,1799,2013,7,98
2842,関口一丁目,2405,4158,1947,2211,2013,7,170
2843,関口二丁目,444,909,423,486,2013,7,14
2844,関口三丁目,437,917,439,478,2013,7,16
2845,目白台一丁目,1316,2235,1266,969,2013,7,42
2846,目白台二丁目,1104,2024,944,1080,2013,7,47
2847,目白台三丁目,1293,2483,1172,1311,2013,7,39
2848,音羽一丁目,2175,3717,1632,2085,2013,7,130
2849,音羽二丁目,980,1735,737,998,2013,7,40
2850,本郷一丁目,1995,3831,1762,2069,2013,7,137
2851,本郷二丁目,1762,2965,1380,1585,2013,7,103
2852,本郷三丁目,1769,2851,1330,1521,2013,7,108
2853,本郷四丁目,2088,3805,1785,2020,2013,7,89
2854,本郷五丁目,1831,3236,1667,1569,2013,7,102
2855,本郷六丁目,1053,1756,909,847,2013,7,47
2856,湯島一丁目,444,673,293,380,2013,7,43
2857,湯島二丁目,1454,2392,1218,1174,2013,7,147
2858,湯島三丁目,1835,2886,1438,1448,2013,7,198
2859,湯島四丁目,1151,2049,1051,998,2013,7,53
2860,西片一丁目,1161,2392,1128,1264,2013,7,44
2861,西片二丁目,1432,2865,1430,1435,2013,7,72
2862,向丘一丁目,1787,3287,1655,1632,2013,7,111
2863,向丘二丁目,1879,3250,1533,1717,2013,7,96
2864,弥生一丁目,254,443,224,219,2013,7,7
2865,弥生二丁目,815,1536,736,800,2013,7,36
2866,根津一丁目,1297,2357,1058,1299,2013,7,35
2867,根津二丁目,2137,3723,1761,1962,2013,7,73
2868,千駄木一丁目,710,1452,669,783,2013,7,22
2869,千駄木二丁目,2437,4325,2028,2297,2013,7,115
2870,千駄木三丁目,3551,6419,3061,3358,2013,7,182
2871,千駄木四丁目,1598,2923,1446,1477,2013,7,96
2872,千駄木五丁目,2251,4560,2178,2382,2013,7,100
2873,本駒込一丁目,2215,4293,2019,2274,2013,7,128
2874,本駒込二丁目,2479,4698,2258,2440,2013,7,103
2875,本駒込三丁目,1779,3156,1491,1665,2013,7,98
2876,本駒込四丁目,2085,4101,1981,2120,2013,7,119
2877,本駒込五丁目,2881,5383,2605,2778,2013,7,167
2878,本駒込六丁目,1602,3209,1456,1753,2013,7,70
2879,後楽一丁目,555,864,481,383,2013,8,8
2880,後楽二丁目,836,1488,751,737,2013,8,65
2881,春日一丁目,963,1527,704,823,2013,8,48
2882,春日二丁目,1975,3908,1877,2031,2013,8,86
2883,小石川一丁目,2019,3711,1692,2019,2013,8,67
2884,小石川二丁目,2091,3801,1789,2012,2013,8,85
2885,小石川三丁目,2421,4963,2358,2605,2013,8,76
2886,小石川四丁目,1697,3368,1492,1876,2013,8,89
2887,小石川五丁目,2872,5444,2529,2915,2013,8,137
2888,白山一丁目,2536,4569,2246,2323,2013,8,125
2889,白山二丁目,2150,3980,1937,2043,2013,8,112
2890,白山三丁目,519,1018,489,529,2013,8,20
2891,白山四丁目,2242,4334,2065,2269,2013,8,77
2892,白山五丁目,2101,3747,1730,2017,2013,8,109
2893,千石一丁目,1830,3787,1779,2008,2013,8,49
2894,千石二丁目,1933,3923,1856,2067,2013,8,74
2895,千石三丁目,2128,4257,2076,2181,2013,8,85
2896,千石四丁目,3059,5296,2524,2772,2013,8,144
2897,水道一丁目,1349,2484,1209,1275,2013,8,72
2898,水道二丁目,1797,2898,1479,1419,2013,8,150
2899,小日向一丁目,1068,2095,955,1140,2013,8,22
2900,小日向二丁目,1070,2422,1171,1251,2013,8,21
2901,小日向三丁目,651,1298,640,658,2013,8,24
2902,小日向四丁目,832,1529,722,807,2013,8,48
2903,大塚一丁目,546,1182,549,633,2013,8,13
2904,大塚二丁目,985,1830,801,1029,2013,8,21
2905,大塚三丁目,1917,3250,1490,1760,2013,8,150
2906,大塚四丁目,1667,2902,1334,1568,2013,8,78
2907,大塚五丁目,2285,4165,1986,2179,2013,8,108
2908,大塚六丁目,2124,3666,1865,1801,2013,8,87
2909,関口一丁目,2411,4170,1961,2209,2013,8,155
2910,関口二丁目,447,912,427,485,2013,8,15
2911,関口三丁目,439,919,439,480,2013,8,14
2912,目白台一丁目,1304,2224,1253,971,2013,8,32
2913,目白台二丁目,1103,2020,945,1075,2013,8,46
2914,目白台三丁目,1285,2479,1171,1308,2013,8,34
2915,音羽一丁目,2181,3737,1644,2093,2013,8,202
2916,音羽二丁目,981,1734,735,999,2013,8,39
2917,本郷一丁目,1990,3819,1749,2070,2013,8,122
2918,本郷二丁目,1775,2990,1395,1595,2013,8,93
2919,本郷三丁目,1769,2841,1326,1515,2013,8,111
2920,本郷四丁目,2090,3817,1793,2024,2013,8,75
2921,本郷五丁目,1829,3244,1667,1577,2013,8,106
2922,本郷六丁目,1059,1764,909,855,2013,8,37
2923,湯島一丁目,442,666,289,377,2013,8,39
2924,湯島二丁目,1466,2410,1220,1190,2013,8,157
2925,湯島三丁目,1838,2889,1439,1450,2013,8,172
2926,湯島四丁目,1146,2038,1047,991,2013,8,58
2927,西片一丁目,1155,2382,1128,1254,2013,8,46
2928,西片二丁目,1449,2891,1445,1446,2013,8,59
2929,向丘一丁目,1782,3283,1648,1635,2013,8,107
2930,向丘二丁目,1873,3243,1530,1713,2013,8,94
2931,弥生一丁目,255,444,225,219,2013,8,14
2932,弥生二丁目,815,1537,735,802,2013,8,33
2933,根津一丁目,1307,2370,1064,1306,2013,8,47
2934,根津二丁目,2144,3735,1766,1969,2013,8,83
2935,千駄木一丁目,715,1463,678,785,2013,8,19
2936,千駄木二丁目,2443,4334,2029,2305,2013,8,113
2937,千駄木三丁目,3537,6404,3050,3354,2013,8,177
2938,千駄木四丁目,1593,2913,1437,1476,2013,8,75
2939,千駄木五丁目,2255,4564,2182,2382,2013,8,96
2940,本駒込一丁目,2225,4318,2035,2283,2013,8,125
2941,本駒込二丁目,2475,4699,2258,2441,2013,8,114
2942,本駒込三丁目,1779,3155,1486,1669,2013,8,86
2943,本駒込四丁目,2087,4102,1983,2119,2013,8,112
2944,本駒込五丁目,2890,5404,2623,2781,2013,8,164
2945,本駒込六丁目,1601,3202,1449,1753,2013,8,73
2946,後楽一丁目,548,851,472,379,2013,9,3
2947,後楽二丁目,832,1484,749,735,2013,9,70
2948,春日一丁目,963,1526,699,827,2013,9,44
2949,春日二丁目,1977,3918,1878,2040,2013,9,93
2950,小石川一丁目,2027,3715,1691,2024,2013,9,101
2951,小石川二丁目,2096,3812,1792,2020,2013,9,72
2952,小石川三丁目,2426,4969,2361,2608,2013,9,85
2953,小石川四丁目,1705,3375,1492,1883,2013,9,80
2954,小石川五丁目,2876,5468,2539,2929,2013,9,114
2955,白山一丁目,2531,4567,2241,2326,2013,9,133
2956,白山二丁目,2158,3995,1947,2048,2013,9,113
2957,白山三丁目,524,1026,494,532,2013,9,14
2958,白山四丁目,2247,4344,2068,2276,2013,9,70
2959,白山五丁目,2089,3727,1725,2002,2013,9,121
2960,千石一丁目,1834,3792,1777,2015,2013,9,49
2961,千石二丁目,1935,3919,1860,2059,2013,9,80
2962,千石三丁目,2123,4258,2077,2181,2013,9,75
2963,千石四丁目,3055,5308,2530,2778,2013,9,151
2964,水道一丁目,1360,2505,1214,1291,2013,9,82
2965,水道二丁目,1799,2899,1472,1427,2013,9,144
2966,小日向一丁目,1065,2088,951,1137,2013,9,18
2967,小日向二丁目,1070,2421,1171,1250,2013,9,24
2968,小日向三丁目,651,1300,640,660,2013,9,23
2969,小日向四丁目,840,1527,723,804,2013,9,41
2970,大塚一丁目,546,1186,552,634,2013,9,10
2971,大塚二丁目,984,1824,801,1023,2013,9,25
2972,大塚三丁目,1917,3243,1482,1761,2013,9,165
2973,大塚四丁目,1651,2883,1321,1562,2013,9,79
2974,大塚五丁目,2285,4168,1987,2181,2013,9,104
2975,大塚六丁目,2122,3663,1860,1803,2013,9,90
2976,関口一丁目,2409,4168,1960,2208,2013,9,176
2977,関口二丁目,448,914,429,485,2013,9,12
2978,関口三丁目,441,923,442,481,2013,9,21
2979,目白台一丁目,1285,2209,1238,971,2013,9,47
2980,目白台二丁目,1109,2030,952,1078,2013,9,50
2981,目白台三丁目,1294,2491,1178,1313,2013,9,39
2982,音羽一丁目,2181,3730,1641,2089,2013,9,222
2983,音羽二丁目,975,1734,735,999,2013,9,37
2984,本郷一丁目,1984,3805,1735,2070,2013,9,107
2985,本郷二丁目,1793,3008,1402,1606,2013,9,98
2986,本郷三丁目,1772,2841,1327,1514,2013,9,116
2987,本郷四丁目,2094,3831,1797,2034,2013,9,69
2988,本郷五丁目,1833,3251,1674,1577,2013,9,91
2989,本郷六丁目,1072,1783,918,865,2013,9,48
2990,湯島一丁目,445,672,288,384,2013,9,46
2991,湯島二丁目,1466,2405,1214,1191,2013,9,218
2992,湯島三丁目,1837,2887,1440,1447,2013,9,156
2993,湯島四丁目,1148,2046,1054,992,2013,9,47
2994,西片一丁目,1160,2388,1132,1256,2013,9,55
2995,西片二丁目,1449,2887,1446,1441,2013,9,53
2996,向丘一丁目,1779,3271,1639,1632,2013,9,100
2997,向丘二丁目,1867,3246,1529,1717,2013,9,84
2998,弥生一丁目,254,440,221,219,2013,9,10
2999,弥生二丁目,813,1540,736,804,2013,9,34
3000,根津一丁目,1322,2387,1067,1320,2013,9,62
3001,根津二丁目,2134,3725,1766,1959,2013,9,87
3002,千駄木一丁目,712,1459,677,782,2013,9,21
3003,千駄木二丁目,2438,4329,2027,2302,2013,9,114
3004,千駄木三丁目,3534,6408,3049,3359,2013,9,190
3005,千駄木四丁目,1603,2943,1457,1486,2013,9,84
3006,千駄木五丁目,2262,4568,2188,2380,2013,9,83
3007,本駒込一丁目,2222,4311,2027,2284,2013,9,111
3008,本駒込二丁目,2472,4701,2257,2444,2013,9,98
3009,本駒込三丁目,1772,3151,1484,1667,2013,9,84
3010,本駒込四丁目,2089,4103,1991,2112,2013,9,95
3011,本駒込五丁目,2890,5401,2619,2782,2013,9,152
3012,本駒込六丁目,1597,3200,1441,1759,2013,9,80
3013,後楽一丁目,531,830,458,372,2013,10,7
3014,後楽二丁目,828,1479,744,735,2013,10,69
3015,春日一丁目,967,1529,702,827,2013,10,55
3016,春日二丁目,1971,3909,1875,2034,2013,10,111
3017,小石川一丁目,2021,3715,1696,2019,2013,10,105
3018,小石川二丁目,2102,3816,1791,2025,2013,10,87
3019,小石川三丁目,2429,4962,2361,2601,2013,10,103
3020,小石川四丁目,1702,3368,1489,1879,2013,10,91
3021,小石川五丁目,2869,5454,2526,2928,2013,10,136
3022,白山一丁目,2532,4569,2239,2330,2013,10,124
3023,白山二丁目,2164,4002,1957,2045,2013,10,98
3024,白山三丁目,525,1022,490,532,2013,10,14
3025,白山四丁目,2239,4323,2057,2266,2013,10,77
3026,白山五丁目,2086,3716,1716,2000,2013,10,127
3027,千石一丁目,1839,3808,1787,2021,2013,10,54
3028,千石二丁目,1929,3921,1860,2061,2013,10,64
3029,千石三丁目,2128,4262,2083,2179,2013,10,71
3030,千石四丁目,3052,5307,2532,2775,2013,10,178
3031,水道一丁目,1358,2503,1211,1292,2013,10,78
3032,水道二丁目,1806,2906,1471,1435,2013,10,149
3033,小日向一丁目,1066,2092,954,1138,2013,10,20
3034,小日向二丁目,1068,2415,1172,1243,2013,10,21
3035,小日向三丁目,648,1296,636,660,2013,10,18
3036,小日向四丁目,862,1572,747,825,2013,10,46
3037,大塚一丁目,548,1190,553,637,2013,10,10
3038,大塚二丁目,994,1843,808,1035,2013,10,18
3039,大塚三丁目,1927,3266,1498,1768,2013,10,171
3040,大塚四丁目,1671,2904,1338,1566,2013,10,69
3041,大塚五丁目,2287,4171,1985,2186,2013,10,128
3042,大塚六丁目,2128,3671,1858,1813,2013,10,106
3043,関口一丁目,2418,4184,1967,2217,2013,10,199
3044,関口二丁目,447,910,429,481,2013,10,12
3045,関口三丁目,439,921,440,481,2013,10,34
3046,目白台一丁目,1312,2241,1255,986,2013,10,43
3047,目白台二丁目,1113,2030,951,1079,2013,10,46
3048,目白台三丁目,1297,2488,1178,1310,2013,10,40
3049,音羽一丁目,2192,3761,1661,2100,2013,10,199
3050,音羽二丁目,971,1726,731,995,2013,10,37
3051,本郷一丁目,2004,3834,1748,2086,2013,10,120
3052,本郷二丁目,1789,3004,1395,1609,2013,10,108
3053,本郷三丁目,1781,2856,1339,1517,2013,10,109
3054,本郷四丁目,2099,3829,1800,2029,2013,10,68
3055,本郷五丁目,1832,3255,1676,1579,2013,10,90
3056,本郷六丁目,1070,1787,918,869,2013,10,55
3057,湯島一丁目,444,669,285,384,2013,10,45
3058,湯島二丁目,1458,2393,1209,1184,2013,10,199
3059,湯島三丁目,1840,2892,1442,1450,2013,10,176
3060,湯島四丁目,1147,2047,1051,996,2013,10,47
3061,西片一丁目,1156,2376,1127,1249,2013,10,54
3062,西片二丁目,1448,2886,1446,1440,2013,10,48
3063,向丘一丁目,1776,3268,1641,1627,2013,10,96
3064,向丘二丁目,1892,3268,1538,1730,2013,10,88
3065,弥生一丁目,254,441,223,218,2013,10,8
3066,弥生二丁目,817,1542,735,807,2013,10,29
3067,根津一丁目,1319,2390,1068,1322,2013,10,47
3068,根津二丁目,2131,3715,1760,1955,2013,10,87
3069,千駄木一丁目,710,1463,679,784,2013,10,21
3070,千駄木二丁目,2442,4326,2021,2305,2013,10,127
3071,千駄木三丁目,3588,6470,3069,3401,2013,10,210
3072,千駄木四丁目,1601,2951,1456,1495,2013,10,79
3073,千駄木五丁目,2255,4557,2185,2372,2013,10,90
3074,本駒込一丁目,2227,4316,2034,2282,2013,10,107
3075,本駒込二丁目,2474,4701,2260,2441,2013,10,111
3076,本駒込三丁目,1776,3154,1486,1668,2013,10,86
3077,本駒込四丁目,2094,4106,1996,2110,2013,10,89
3078,本駒込五丁目,2904,5420,2622,2798,2013,10,155
3079,本駒込六丁目,1605,3202,1439,1763,2013,10,89
3080,後楽一丁目,538,836,461,375,2013,11,12
3081,後楽二丁目,829,1480,743,737,2013,11,92
3082,春日一丁目,971,1534,710,824,2013,11,56
3083,春日二丁目,1973,3904,1868,2036,2013,11,111
3084,小石川一丁目,2017,3713,1700,2013,2013,11,116
3085,小石川二丁目,2098,3812,1788,2024,2013,11,81
3086,小石川三丁目,2423,4949,2357,2592,2013,11,107
3087,小石川四丁目,1699,3362,1490,1872,2013,11,92
3088,小石川五丁目,2873,5443,2525,2918,2013,11,120
3089,白山一丁目,2525,4552,2231,2321,2013,11,123
3090,白山二丁目,2167,4009,1957,2052,2013,11,104
3091,白山三丁目,525,1026,492,534,2013,11,14
3092,白山四丁目,2242,4324,2061,2263,2013,11,79
3093,白山五丁目,2084,3700,1708,1992,2013,11,118
3094,千石一丁目,1838,3809,1788,2021,2013,11,61
3095,千石二丁目,1933,3929,1863,2066,2013,11,69
3096,千石三丁目,2125,4262,2083,2179,2013,11,74
3097,千石四丁目,3034,5285,2520,2765,2013,11,207
3098,水道一丁目,1367,2519,1223,1296,2013,11,85
3099,水道二丁目,1826,2935,1485,1450,2013,11,162
3100,小日向一丁目,1073,2100,954,1146,2013,11,21
3101,小日向二丁目,1070,2415,1172,1243,2013,11,18
3102,小日向三丁目,657,1305,640,665,2013,11,18
3103,小日向四丁目,926,1725,819,906,2013,11,51
3104,大塚一丁目,548,1187,551,636,2013,11,10
3105,大塚二丁目,993,1842,807,1035,2013,11,19
3106,大塚三丁目,1935,3265,1499,1766,2013,11,163
3107,大塚四丁目,1696,2936,1349,1587,2013,11,58
3108,大塚五丁目,2311,4212,2002,2210,2013,11,108
3109,大塚六丁目,2127,3662,1843,1819,2013,11,92
3110,関口一丁目,2420,4183,1963,2220,2013,11,235
3111,関口二丁目,445,907,427,480,2013,11,9
3112,関口三丁目,440,918,437,481,2013,11,30
3113,目白台一丁目,1326,2271,1269,1002,2013,11,33
3114,目白台二丁目,1128,2049,962,1087,2013,11,37
3115,目白台三丁目,1305,2499,1186,1313,2013,11,31
3116,音羽一丁目,2208,3779,1669,2110,2013,11,175
3117,音羽二丁目,970,1727,736,991,2013,11,41
3118,本郷一丁目,2002,3823,1744,2079,2013,11,123
3119,本郷二丁目,1787,3009,1406,1603,2013,11,109
3120,本郷三丁目,1785,2867,1343,1524,2013,11,125
3121,本郷四丁目,2113,3842,1802,2040,2013,11,78
3122,本郷五丁目,1827,3257,1675,1582,2013,11,68
3123,本郷六丁目,1065,1782,913,869,2013,11,51
3124,湯島一丁目,442,670,287,383,2013,11,41
3125,湯島二丁目,1474,2415,1220,1195,2013,11,203
3126,湯島三丁目,1842,2891,1450,1441,2013,11,185
3127,湯島四丁目,1156,2058,1056,1002,2013,11,57
3128,西片一丁目,1153,2367,1122,1245,2013,11,67
3129,西片二丁目,1456,2908,1459,1449,2013,11,42
3130,向丘一丁目,1806,3303,1663,1640,2013,11,94
3131,向丘二丁目,1900,3280,1543,1737,2013,11,78
3132,弥生一丁目,256,445,222,223,2013,11,6
3133,弥生二丁目,826,1543,744,799,2013,11,27
3134,根津一丁目,1328,2410,1079,1331,2013,11,44
3135,根津二丁目,2134,3726,1765,1961,2013,11,78
3136,千駄木一丁目,707,1455,675,780,2013,11,27
3137,千駄木二丁目,2432,4325,2021,2304,2013,11,109
3138,千駄木三丁目,3588,6467,3070,3397,2013,11,203
3139,千駄木四丁目,1592,2947,1452,1495,2013,11,84
3140,千駄木五丁目,2249,4561,2190,2371,2013,11,81
3141,本駒込一丁目,2232,4327,2045,2282,2013,11,108
3142,本駒込二丁目,2485,4715,2269,2446,2013,11,89
3143,本駒込三丁目,1784,3169,1499,1670,2013,11,74
3144,本駒込四丁目,2103,4122,2004,2118,2013,11,89
3145,本駒込五丁目,2930,5445,2633,2812,2013,11,193
3146,本駒込六丁目,1609,3212,1450,1762,2013,11,76
3147,後楽一丁目,523,822,445,377,2013,12,13
3148,後楽二丁目,825,1480,744,736,2013,12,88
3149,春日一丁目,973,1538,713,825,2013,12,64
3150,春日二丁目,1965,3887,1856,2031,2013,12,106
3151,小石川一丁目,2008,3704,1701,2003,2013,12,93
3152,小石川二丁目,2085,3794,1783,2011,2013,12,79
3153,小石川三丁目,2416,4951,2358,2593,2013,12,73
3154,小石川四丁目,1702,3372,1499,1873,2013,12,79
3155,小石川五丁目,2859,5425,2515,2910,2013,12,138
3156,白山一丁目,2524,4549,2231,2318,2013,12,124
3157,白山二丁目,2179,4035,1971,2064,2013,12,104
3158,白山三丁目,525,1032,494,538,2013,12,23
3159,白山四丁目,2240,4324,2060,2264,2013,12,75
3160,白山五丁目,2067,3672,1694,1978,2013,12,116
3161,千石一丁目,1854,3838,1802,2036,2013,12,57
3162,千石二丁目,1922,3911,1854,2057,2013,12,71
3163,千石三丁目,2115,4249,2073,2176,2013,12,68
3164,千石四丁目,3026,5287,2526,2761,2013,12,219
3165,水道一丁目,1366,2526,1224,1302,2013,12,75
3166,水道二丁目,1823,2929,1486,1443,2013,12,146
3167,小日向一丁目,1076,2106,958,1148,2013,12,11
3168,小日向二丁目,1065,2396,1164,1232,2013,12,25
3169,小日向三丁目,656,1305,639,666,2013,12,19
3170,小日向四丁目,924,1727,823,904,2013,12,61
3171,大塚一丁目,551,1189,552,637,2013,12,8
3172,大塚二丁目,992,1837,803,1034,2013,12,62
3173,大塚三丁目,1942,3269,1500,1769,2013,12,153
3174,大塚四丁目,1695,2933,1347,1586,2013,12,61
3175,大塚五丁目,2320,4219,2005,2214,2013,12,113
3176,大塚六丁目,2116,3653,1836,1817,2013,12,102
3177,関口一丁目,2413,4170,1960,2210,2013,12,219
3178,関口二丁目,446,909,427,482,2013,12,14
3179,関口三丁目,440,919,436,483,2013,12,29
3180,目白台一丁目,1322,2260,1261,999,2013,12,35
3181,目白台二丁目,1132,2052,967,1085,2013,12,29
3182,目白台三丁目,1304,2508,1191,1317,2013,12,25
3183,音羽一丁目,2226,3804,1684,2120,2013,12,148
3184,音羽二丁目,976,1733,742,991,2013,12,37
3185,本郷一丁目,1994,3809,1742,2067,2013,12,106
3186,本郷二丁目,1777,2998,1402,1596,2013,12,99
3187,本郷三丁目,1782,2857,1337,1520,2013,12,104
3188,本郷四丁目,2121,3850,1809,2041,2013,12,70
3189,本郷五丁目,1813,3246,1664,1582,2013,12,101
3190,本郷六丁目,1057,1769,911,858,2013,12,63
3191,湯島一丁目,438,664,288,376,2013,12,40
3192,湯島二丁目,1482,2428,1224,1204,2013,12,150
3193,湯島三丁目,1836,2881,1436,1445,2013,12,143
3194,湯島四丁目,1149,2049,1054,995,2013,12,53
3195,西片一丁目,1162,2385,1129,1256,2013,12,53
3196,西片二丁目,1457,2909,1458,1451,2013,12,43
3197,向丘一丁目,1793,3291,1655,1636,2013,12,94
3198,向丘二丁目,1890,3278,1546,1732,2013,12,64
3199,弥生一丁目,256,445,222,223,2013,12,5
3200,弥生二丁目,825,1547,749,798,2013,12,32
3201,根津一丁目,1348,2437,1091,1346,2013,12,31
3202,根津二丁目,2130,3717,1761,1956,2013,12,71
3203,千駄木一丁目,711,1461,678,783,2013,12,20
3204,千駄木二丁目,2437,4339,2024,2315,2013,12,113
3205,千駄木三丁目,3584,6458,3066,3392,2013,12,205
3206,千駄木四丁目,1581,2928,1444,1484,2013,12,81
3207,千駄木五丁目,2260,4581,2202,2379,2013,12,94
3208,本駒込一丁目,2231,4324,2044,2280,2013,12,90
3209,本駒込二丁目,2489,4728,2278,2450,2013,12,95
3210,本駒込三丁目,1796,3187,1510,1677,2013,12,70
3211,本駒込四丁目,2096,4105,1995,2110,2013,12,89
3212,本駒込五丁目,2937,5458,2644,2814,2013,12,193
3213,本駒込六丁目,1612,3215,1448,1767,2013,12,65
